"uuid","sentiment","sentiment_pos","sentiment_neg","average_sentiment","n_pos","n_neg","n_words","sentiment_label","title","date_updated_at","date_published_at"
"ad969ecf-ae75-4db8-b63a-daae6efd945a",-1,13,-14,-0.00925925925925926,11,8,19,"Negative","Sundhedsstyrelsen indkøber jodtabletter i tilfælde af ""væsentligt radioaktivt udslip"" (ad969ecf-ae75-4db8-b63a-daae6efd945a)",2022-04-11 10:39:53,2022-04-11 10:39:53
"e2b1abf8-efbc-403f-8458-e2999b6e4f40",1,3,-2,0.0454545454545455,2,2,4,"Positive","Her er ti familieaktiviteter til påskeferien på Fyn (e2b1abf8-efbc-403f-8458-e2999b6e4f40)",2022-04-11 11:13:10,2022-04-11 11:13:10
"029eadbd-4850-4e04-b432-ba4a4312b54f",-12,18,-30,-0.130434782608696,14,16,30,"Negative","Betinget fængsel: Vennepar dømt skyldig i svindel med coronahjælpepakke (029eadbd-4850-4e04-b432-ba4a4312b54f)",2022-01-07 08:21:07,2022-01-07 08:21:07
"0a8157ac-77ae-4360-9a62-d1b0e23615ad",20,29,-9,0.210526315789474,17,5,22,"Positive","Eriksen giver første interview efter sit hjertestop (0a8157ac-77ae-4360-9a62-d1b0e23615ad)",2022-01-04 16:04:16,2022-01-04 16:04:16
"0b14d6bd-7584-4338-9a0b-c1b6fda37de7",29,43,-14,0.21969696969697,24,12,36,"Positive","Odense Håndbold spiller uafgjort med CSKA i Champions League-drama (0b14d6bd-7584-4338-9a0b-c1b6fda37de7)",2022-01-09 15:59:43,2022-01-09 15:59:43
"0fc7c2d4-0325-4795-89c6-b624d935a418",22,41,-19,0.176,24,16,40,"Positive","OB-træner om halvsæson: Vi skal vinde - ellers er det ligemeget (0fc7c2d4-0325-4795-89c6-b624d935a418)",2022-01-06 14:27:18,2022-01-06 14:27:18
"107b142e-a702-490f-a148-6634966bdc4f",-2,14,-16,-0.0196078431372549,10,8,18,"Negative","Nyt studie: Fire ud af fem coronaindlagte døjer med senfølger (107b142e-a702-490f-a148-6634966bdc4f)",2022-01-09 11:35:17,2022-01-09 11:35:17
"1096a2a7-1af2-4046-a3e6-58262b02cf26",0,24,-24,0,14,16,30,"Negative","Flere centre tilbyder nu drop-in-vacciner på Fyn (1096a2a7-1af2-4046-a3e6-58262b02cf26)",2022-01-06 16:10:25,2022-01-06 16:10:25
"126fb979-a516-4592-8abb-4e1a414f86c5",33,47,-14,0.189655172413793,26,10,36,"Positive","Første dag tilbage på skolen: - Det er så dejligt (126fb979-a516-4592-8abb-4e1a414f86c5)",2022-01-05 18:21:19,2022-01-05 18:21:19
"1398fad0-ab6b-486e-8756-388069242405",13,35,-22,0.0797546012269939,22,16,38,"Positive","Politisk flertal vil stramme coronapasset (1398fad0-ab6b-486e-8756-388069242405)",2022-01-06 09:39:21,2022-01-06 09:39:21
"1498681a-2985-4ecc-9d05-6ccf5355a4fd",-5,15,-20,-0.0403225806451613,13,14,27,"Negative","Christian Eriksen: Jeg tænkte, det var slut i ambulancen (1498681a-2985-4ecc-9d05-6ccf5355a4fd)",2022-01-06 05:45:01,2022-01-06 05:45:01
"14a29588-c40e-4ae5-9cdd-dc0c0c5e5895",0,9,-9,0,6,5,11,"Negative","Næsten 10.000 fynboer har fået en positiv test den seneste uge (14a29588-c40e-4ae5-9cdd-dc0c0c5e5895)",2022-01-06 13:23:00,2022-01-06 13:23:00
"1792909c-6095-41ee-ac2a-76f9a4f6ffdc",30,45,-15,0.245901639344262,25,9,34,"Positive","Fynsk stjernefrø nomineret til en af Danmarks største filmpriser: - Vildt, at jeg har sådan en drømmedebut (1792909c-6095-41ee-ac2a-76f9a4f6ffdc)",2022-01-06 08:50:03,2022-01-06 08:50:03
"1dcbd4e7-662e-4dc5-8d8b-5b4ea4723cae",7,13,-6,0.0714285714285714,8,6,14,"Positive","På liste med Milano og Valencia: Kendt magasin kårer Odense til en af Europas byperler (1dcbd4e7-662e-4dc5-8d8b-5b4ea4723cae)",2022-01-07 19:45:42,2022-01-07 19:45:42
"20e82dc2-8fb5-4f0e-8ef3-f93cd0d9e8f0",-9,37,-46,-0.0375,27,28,55,"Negative","Forflyttet betjent får medhold i klage: - Jeg fortryder det ikke (20e82dc2-8fb5-4f0e-8ef3-f93cd0d9e8f0)",2022-01-07 12:30:00,2022-01-06 19:53:17
"26d649a0-7c0e-4f31-93f7-6cc1313760e1",-4,45,-49,-0.0199004975124378,29,29,58,"Negative","Efter afsløring af byggesjusk: Grønnely giver lyd fra sig (26d649a0-7c0e-4f31-93f7-6cc1313760e1)",2022-01-05 16:56:20,2022-01-05 16:56:20
"285a75d4-5214-475a-b120-92cc78005f72",13,28,-15,0.0691489361702128,23,12,35,"Positive","Her er Fyns billigste villa (285a75d4-5214-475a-b120-92cc78005f72)",2022-01-08 06:53:27,2022-01-08 06:53:27
"29e4f890-163a-4271-9b48-aa16d7cad9b6",7,21,-14,0.0564516129032258,14,11,25,"Positive","Nu begynder fastelavnsbolle-sæsonen: Bager solgte de første mellem jul og nytår (29e4f890-163a-4271-9b48-aa16d7cad9b6)",2022-01-07 10:35:00,2022-01-07 10:35:00
"2ca14076-bc07-4292-8e27-acd415d9c9e6",6,7,-1,0.117647058823529,6,1,7,"Positive","Politiet om ransagninger i Vollsmose: Det er en kontrol (2ca14076-bc07-4292-8e27-acd415d9c9e6)",2022-01-05 06:49:49,2022-01-05 06:49:49
"3027805a-6329-4e53-b5f4-c1d071d62d98",17,21,-4,0.17,13,3,16,"Positive","Boligboom på Fyn: Se, hvor mange huse der er solgt i din kommune (3027805a-6329-4e53-b5f4-c1d071d62d98)",2022-01-07 14:46:14,2022-01-07 14:46:14
"3077bb9a-3b69-4264-8c0e-f6910693dd28",-6,17,-23,-0.0618556701030928,12,12,24,"Negative","Storebæltsbroen går i gult til Tour de France - først skal 385 lamper udskiftes (3077bb9a-3b69-4264-8c0e-f6910693dd28)",2022-04-11 08:02:11,2022-04-11 08:02:11
"338ea1fd-b5f9-4892-9f23-714f5b5d716b",-17,13,-30,-0.178947368421053,9,16,25,"Negative","Efter skudepisode: Visitationszone forlænges i Vollsmose (338ea1fd-b5f9-4892-9f23-714f5b5d716b)",2022-01-04 19:10:14,2022-01-04 19:10:14
"34a4ea9e-9109-41d5-b273-5bf9a1cf7728",-7,22,-29,-0.0546875,16,18,34,"Negative","Prognose: Høje energipriser sluger familiers rådighedsbeløb (34a4ea9e-9109-41d5-b273-5bf9a1cf7728)",2022-01-05 08:43:09,2022-01-05 08:43:09
"36139ab6-1667-4894-b768-9918aae32bf8",-9,26,-35,-0.0471204188481675,17,27,44,"Negative","Så mange fynske børn er vaccineret - men giver det overhovedet mening? (36139ab6-1667-4894-b768-9918aae32bf8)",2022-01-05 10:15:03,2022-01-05 10:15:03
"3c7146e0-58f7-4035-99d5-406275be1fa7",5,12,-7,0.0819672131147541,9,4,13,"Positive","Se tal for dit sogn: Sådan ser smitten ud på Fyn (3c7146e0-58f7-4035-99d5-406275be1fa7)",2022-01-05 12:45:03,2022-01-05 12:45:03
"3d509658-a321-480c-9614-59d608a0fa7d",-3,4,-7,-0.0681818181818182,4,5,9,"Negative","Livløs mand reddet op af vandet - nu er han erklæret død (3d509658-a321-480c-9614-59d608a0fa7d)",2022-01-05 09:57:00,2022-01-05 08:14:21
"4281a3f6-532d-4a34-bc84-97835c1fa859",37,64,-27,0.204419889502762,35,19,54,"Positive","90-årige Bent har cyklet i 70 år: - Pas din træning og bliv ved (4281a3f6-532d-4a34-bc84-97835c1fa859)",2022-01-09 17:29:16,2022-01-09 17:29:16
"4591ca8a-7b4d-40fe-b1ee-92775eecb015",5,20,-15,0.029585798816568,11,12,23,"Positive","Selvtest skal holde skoler åbne: - Jeg er helt tryg ved, at de får det gjort (4591ca8a-7b4d-40fe-b1ee-92775eecb015)",2022-01-04 18:07:30,2022-01-04 18:07:30
"45924953-2537-45ea-bc5e-dac7e3c479e2",16,23,-7,0.175824175824176,13,5,18,"Positive","Tag på påske-skattejagt i det sydfynske (45924953-2537-45ea-bc5e-dac7e3c479e2)",2022-04-11 06:51:49,2022-04-11 06:51:49
"490fe5b4-24a4-4292-919c-85552bca7f3d",23,44,-21,0.175572519083969,31,12,43,"Positive","Fynsk virksomhed har fundet genvej til arbejdskraft (490fe5b4-24a4-4292-919c-85552bca7f3d)",2022-01-08 08:40:30,2022-01-08 08:40:30
"511c3dd5-04cb-4994-bcf7-44cac72f494c",-3,9,-12,-0.037037037037037,7,9,16,"Negative","Mindre stigninger: Fyn følger ikke det landsdækkende fald i smittetal (511c3dd5-04cb-4994-bcf7-44cac72f494c)",2022-01-07 13:09:27,2022-01-07 13:09:27
"51d6bbd3-701e-497b-b8af-2ee3fb61ba09",-6,14,-20,-0.0504201680672269,13,14,27,"Negative","Boosterstik mindsker risiko for indlæggelse markant (51d6bbd3-701e-497b-b8af-2ee3fb61ba09)",2022-01-08 05:19:48,2022-01-08 05:19:48
"5556151b-21db-4b32-ab77-185207d6becc",1,40,-39,0.00395256916996047,28,28,56,"Positive","Derfor får danske børn og unge under 18 år ikke tredje stik (5556151b-21db-4b32-ab77-185207d6becc)",2022-01-07 09:28:05,2022-01-07 09:28:05
"565b5f28-957f-4c4c-875d-a2b0c123c819",-4,16,-20,-0.0347826086956522,12,11,23,"Negative","Ejere af forsvundet hund forsøgt afpresset (565b5f28-957f-4c4c-875d-a2b0c123c819)",2022-01-04 14:41:00,2022-01-04 14:41:00
"568d47fb-9096-4768-9a4a-08236d291eb5",0,12,-12,0,9,11,20,"Negative","Så mange fynboer har fået tredje stik (568d47fb-9096-4768-9a4a-08236d291eb5)",2022-01-09 10:01:13,2022-01-09 10:01:13
"57576a9d-3d8e-4e14-a535-70a8804d6d57",13,17,-4,0.203125,11,4,15,"Positive","17 gode råd til at undgå rekordhøje elregninger (57576a9d-3d8e-4e14-a535-70a8804d6d57)",2022-01-18 17:02:00,2022-01-05 15:50:51
"5d62bce6-b1ce-4d42-aea4-e58a3b084e35",-9,23,-32,-0.0559006211180124,16,21,37,"Negative","Flere ønsker lempede restriktioner - men de fejlfortolker Omikron, advarer professor (5d62bce6-b1ce-4d42-aea4-e58a3b084e35)",2022-01-06 20:34:43,2022-01-06 20:34:43
"687df04f-a368-4cb1-9b44-ffc5aab9f732",12,20,-8,0.109090909090909,11,5,16,"Positive","Børnehaveklasseledere undrer sig over fraværende testkrav (687df04f-a368-4cb1-9b44-ffc5aab9f732)",2022-01-04 20:10:04,2022-01-04 20:10:04
"697b6062-e48e-41f7-86ae-35cef7438641",20,28,-8,0.19047619047619,18,6,24,"Positive","Eriksen om hjertestop: Det gik først op for mig i ambulancen (697b6062-e48e-41f7-86ae-35cef7438641)",2022-01-05 17:33:36,2022-01-05 17:33:36
"6d484c55-248e-41c8-82ce-f59ce33aca78",14,22,-8,0.0933333333333333,18,5,23,"Positive","Millionbeløb til Campus Faaborg: - Nu kan vi lave nogle af de ting, vi har haft i støbeskeen (6d484c55-248e-41c8-82ce-f59ce33aca78)",2022-01-05 05:15:31,2022-01-05 05:15:31
"7023510b-dacb-4863-aaba-253daa0b956a",8,33,-25,0.0575539568345324,23,16,39,"Positive","Priserne stiger og stiger: Her bliver det billigere at tænde for radiatoren (7023510b-dacb-4863-aaba-253daa0b956a)",2022-01-08 15:33:32,2022-01-08 15:33:32
"7d6a7c09-a02f-4344-9b04-ac80e42e6ca1",39,59,-20,0.170305676855895,40,12,52,"Positive","Hans trænede slidgigtsmerterne væk: - Jeg har fået et bedre liv (7d6a7c09-a02f-4344-9b04-ac80e42e6ca1)",2022-01-08 14:09:12,2022-01-08 14:09:12
"8031b2e3-6f97-4229-986c-b27f100688f6",5,10,-5,0.0625,6,3,9,"Positive","Tidligere OB-træner får nyt job (8031b2e3-6f97-4229-986c-b27f100688f6)",2022-01-09 11:49:30,2022-01-09 11:49:30
"892123fe-040c-49b7-b740-da467d436c11",16,25,-9,0.122137404580153,16,7,23,"Positive","Endnu ingen købere til Valdemars Slot: - Der er masser af fremvisninger (892123fe-040c-49b7-b740-da467d436c11)",2022-01-06 18:00:04,2022-01-06 18:00:04
"8eb63ed2-d469-4a59-9aaa-735239c745f5",16,50,-34,0.0717488789237668,38,27,65,"Positive","Sundhedsminister vil stramme reglerne for coronapasset (8eb63ed2-d469-4a59-9aaa-735239c745f5)",2022-01-05 19:36:23,2022-01-05 19:36:23
"8fbf011d-aa18-4e3b-bd09-e16947206042",3,14,-11,0.0309278350515464,8,6,14,"Positive","To nye lastbiler på Fyn kører på rapsolie (8fbf011d-aa18-4e3b-bd09-e16947206042)",2022-01-05 04:31:49,2022-01-05 04:31:49
"96d511b7-a37f-4212-9266-36c5619c1b95",-19,17,-36,-0.12751677852349,12,18,30,"Negative","Blå partier kritiserer Bramsen: - Det er en vanvittig situation (96d511b7-a37f-4212-9266-36c5619c1b95)",2022-01-06 16:51:27,2022-01-06 16:51:27
"9da5e657-d0f4-480f-8e22-46dc2c63b061",-50,19,-69,-0.335570469798658,13,34,47,"Negative","Dom i dag: Fynsk vennepar tiltalt for coronasvindel (9da5e657-d0f4-480f-8e22-46dc2c63b061)",2022-01-07 04:37:33,2022-01-07 04:37:33
"a166616c-935c-40bd-924d-d3a7f64cebe4",-14,0,-14,-0.202898550724638,0,13,13,"Negative","Bulldogs spiller igen efter stribevis af aflysninger (a166616c-935c-40bd-924d-d3a7f64cebe4)",2022-01-09 08:42:20,2022-01-09 08:42:20
"a1d18e67-d89c-47db-b438-4f971ee872f5",-20,5,-25,-0.28169014084507,4,12,16,"Negative","Blev inspireret af ""overfaldsporno"": Dreng dømt for voldtægtsforsøg af 12-årig pige (a1d18e67-d89c-47db-b438-4f971ee872f5)",2022-01-04 13:55:42,2022-01-04 13:55:42
"a28e148d-6dee-4eed-976c-4eaa51fdf0e6",2,24,-22,0.0127388535031847,15,15,30,"Positive","Elever skal fortsat møde op trods stigende smittetal: Ingen corona-panik hos de fynske gymnasier (a28e148d-6dee-4eed-976c-4eaa51fdf0e6)",2022-01-05 06:18:44,2022-01-05 06:18:44
"a3428737-cadf-48c3-939e-4e03e273080e",-2,28,-30,-0.0119047619047619,20,17,37,"Negative","Utraditionel metode: Snart kan du søge job i Netto over sms (a3428737-cadf-48c3-939e-4e03e273080e)",2022-01-07 13:50:13,2022-01-07 13:50:13
"a519d767-32ec-4a4d-9683-e93cf2a1f5e9",-7,9,-16,-0.0736842105263158,6,10,16,"Negative","Eriksen fortsætter karrieren: Jeg vil til VM i Qatar (a519d767-32ec-4a4d-9683-e93cf2a1f5e9)",2022-01-04 16:31:55,2022-01-04 16:31:55
"a6ceea7c-fa3f-47a5-b772-a1cb60419a5f",-3,22,-25,-0.0234375,14,16,30,"Negative","Trods stigende smitte: - Indlæggelsestallene følger ikke smittetallene på OUH (a6ceea7c-fa3f-47a5-b772-a1cb60419a5f)",2022-01-06 05:02:34,2022-01-06 05:02:34
"a70cb07e-f61c-4b03-8e05-d62d770a137c",37,50,-13,0.264285714285714,29,9,38,"Positive","Årets første OB-træning: Eriksen-nyhed er populær i Ådalen (a70cb07e-f61c-4b03-8e05-d62d770a137c)",2022-01-05 20:23:05,2022-01-05 20:23:05
"ad6ed14f-a315-4617-bfea-948d13d820a9",-27,9,-36,-0.219512195121951,9,18,27,"Negative","31-årig får fem års fængsel for millionsvindel med coronastøtte (ad6ed14f-a315-4617-bfea-948d13d820a9)",2022-01-05 14:13:33,2022-01-05 14:13:33
"bb4f5b85-c1f3-49e3-874c-7034bfa85c56",-25,26,-51,-0.178571428571429,18,29,47,"Negative","Han erkendte, mens hun nægtede - anklager er tilfreds med dom i coronasvindelsag (bb4f5b85-c1f3-49e3-874c-7034bfa85c56)",2022-01-07 19:10:26,2022-01-07 19:10:26
"c86a0606-b550-40c1-aacf-a78f841233c9",4,33,-29,0.0202020202020202,22,16,38,"Positive","Fynsk byggebranche forarget: Kræver Grønnely sat på porten (c86a0606-b550-40c1-aacf-a78f841233c9)",2022-01-05 19:02:55,2022-01-05 19:02:55
"c905b0e7-0ab9-43f4-a6dc-cb726e66c85d",1,10,-9,0.0113636363636364,6,5,11,"Positive","Fyens Stiftstidendes aflyste 250-års fødselsdag kom fynboerne til gode (c905b0e7-0ab9-43f4-a6dc-cb726e66c85d)",2022-01-04 17:34:04,2022-01-04 17:34:04
"c9ac34c5-1608-472f-bbbe-132acd08c0bd",26,28,-2,0.25,21,1,22,"Positive","A.P. Møller investerer kæmpe millionbeløb i fynsk robotfirma (c9ac34c5-1608-472f-bbbe-132acd08c0bd)",2022-01-05 08:21:18,2022-01-05 08:21:18
"ca00f503-59d9-408c-8808-d3df7e377f83",14,35,-21,0.109375,22,12,34,"Positive","Engelsk klub til Eriksen: Døren er altid åben (ca00f503-59d9-408c-8808-d3df7e377f83)",2022-01-07 17:40:44,2022-01-07 17:40:44
"cb275f8b-d069-4b48-91c1-883050aa4e9b",-8,23,-31,-0.0695652173913043,17,15,32,"Negative","Lavere ledighed: Odense kæmper stadig for at nå landsgennemsnittet (cb275f8b-d069-4b48-91c1-883050aa4e9b)",2022-01-07 16:18:57,2022-01-07 16:18:57
"cf5dc888-cf30-41c3-be4a-b46851828fef",7,23,-16,0.0666666666666667,19,10,29,"Positive","Vaccine-demonstration i Odense: Kontroversiel præst holdt tale til fremmødte (cf5dc888-cf30-41c3-be4a-b46851828fef)",2022-01-07 19:52:34,2022-01-07 19:52:34
"cffded80-473c-4dc9-b427-dffe3e0dd82f",3,17,-14,0.0384615384615385,8,8,16,"Positive","Småvinterligt vejr fortsætter på Fyn (cffded80-473c-4dc9-b427-dffe3e0dd82f)",2022-01-08 05:51:11,2022-01-08 05:51:11
"d23a6787-6ee9-4a1c-ad75-77bf82d1b351",16,19,-3,0.120300751879699,12,2,14,"Positive","Elever sang og dansede sig tilbage på efterskole (d23a6787-6ee9-4a1c-ad75-77bf82d1b351)",2022-01-08 19:00:04,2022-01-08 19:00:04
"d2e2a51b-76b0-41df-8910-54e6a8bc5646",-21,5,-26,-0.233333333333333,4,16,20,"Negative","Lørdagens coronatal: Endelig falder coronasmitten på Fyn (d2e2a51b-76b0-41df-8910-54e6a8bc5646)",2022-01-08 12:14:51,2022-01-08 12:14:51
"d2e689c7-a11d-4bf9-a4f3-eca622551585",0,6,-6,0,4,4,8,"Negative","OB eller ej: Her er fem bud på Eriksens næste klub (d2e689c7-a11d-4bf9-a4f3-eca622551585)",2022-01-05 06:12:40,2022-01-05 06:12:40
"dff174d9-4ed0-42db-bdac-ead2f98e6fd9",11,44,-33,0.0533980582524272,32,23,55,"Positive","Kulturlivet efterlyser langsigtet genåbningsplan: - Vi kan ende med at producere til skraldespanden (dff174d9-4ed0-42db-bdac-ead2f98e6fd9)",2022-01-07 06:47:49,2022-01-07 06:47:49
"e1573569-65ba-4f29-9c76-8811ee5f41e6",-8,1,-9,-0.205128205128205,1,4,5,"Negative","Har du set: Politi efterlyser overfaldsmand (e1573569-65ba-4f29-9c76-8811ee5f41e6)",2022-01-05 07:35:53,2022-01-05 07:35:53
"e74e6d7f-228b-422b-a949-0988a7f46dac",-8,11,-19,-0.0567375886524823,8,14,22,"Negative","Coronasmitte på efterskoler kan sende bofæller hjem (e74e6d7f-228b-422b-a949-0988a7f46dac)",2022-01-09 05:17:42,2022-01-09 05:17:42
"e9f8bfee-cbf1-4915-affb-bc99e8cedf67",4,21,-17,0.0344827586206897,11,12,23,"Positive","Elpriser på himmelflugt: Så meget stiger elregningen for fynboerne (e9f8bfee-cbf1-4915-affb-bc99e8cedf67)",2022-01-05 14:01:08,2022-01-05 14:01:08
"eabe9060-fa4c-441a-859a-f8e4347ed673",-20,44,-64,-0.087719298245614,33,40,73,"Negative","Lejere står svagt efter byggesjusk: - Det er abnormt, at udlejer behandler lejerne så dårligt (eabe9060-fa4c-441a-859a-f8e4347ed673)",2022-01-04 15:56:39,2022-01-04 15:56:39
"ec58e507-16cd-4a26-9c6d-f9ac8f22557c",18,30,-12,0.13953488372093,17,8,25,"Positive","Odense skal stå i spidsen: Stort millionbeløb til forskning i gravide med diabetes (ec58e507-16cd-4a26-9c6d-f9ac8f22557c)",2022-01-08 17:26:08,2022-01-08 17:26:08
"f02a8deb-dc41-473e-9743-eb89b16efe52",51,78,-27,0.177700348432056,51,17,68,"Positive","Forskere sår tvivl om hjemmetests: - Forbrugerne har ikke en chance (f02a8deb-dc41-473e-9743-eb89b16efe52)",2022-01-06 07:21:56,2022-01-06 07:21:56
"f513d76c-ad20-41b3-91df-88e9a40e52b2",-10,8,-18,-0.178571428571429,4,9,13,"Negative","Front med tøsne passerer Fyn (f513d76c-ad20-41b3-91df-88e9a40e52b2)",2022-01-09 05:47:55,2022-01-09 05:47:55
"f69b6050-45ff-4deb-a3a8-72481075e355",-5,10,-15,-0.0675675675675676,5,11,16,"Negative","Lille sæl soler sig på havnen - derfor skal du lade den være (f69b6050-45ff-4deb-a3a8-72481075e355)",2022-01-08 09:30:48,2022-01-08 09:30:48
"fdbb6d74-d0c3-4b48-8c68-abb3666aa093",-10,4,-14,-0.117647058823529,2,8,10,"Negative","Søndagens coronatal: Antallet af smittede stiger igen (fdbb6d74-d0c3-4b48-8c68-abb3666aa093)",2022-01-09 13:00:17,2022-01-09 13:00:17
"0dcba91b-bdbf-4eb2-8af6-9a2066ea9629",26,32,-6,0.218487394957983,21,3,24,"Positive","Flemming har 17 brugte cykler i laden: Turister skal kunne køre gratis rundt på fynsk ø (0dcba91b-bdbf-4eb2-8af6-9a2066ea9629)",2022-04-09 03:13:34,2022-04-09 03:13:34
"0ecd1ade-a282-4729-bdd5-a3158ce2b508",-36,53,-89,-0.107142857142857,38,50,88,"Negative","Hvis krigen kommer: Ulrich fra Nordfyn har gasmasker og dåsemad klar i kælderen (0ecd1ade-a282-4729-bdd5-a3158ce2b508)",2022-04-10 05:50:47,2022-04-10 05:50:47
"0f2b9d87-a773-4cfb-af23-cc5cb3202eee",8,12,-4,0.119402985074627,7,3,10,"Positive","Flot start på weekendvejret - men så får skyerne fat (0f2b9d87-a773-4cfb-af23-cc5cb3202eee)",2022-04-09 03:47:55,2022-04-09 03:47:55
"2a0f732e-17fc-43be-b7b3-633c2b2dd926",-2,32,-34,-0.0100502512562814,23,19,42,"Negative","Marianne fik fjernet sit barn: Advokat er rystet og kalder Langelands sagsbehandling for dårlig (2a0f732e-17fc-43be-b7b3-633c2b2dd926)",2022-04-08 15:25:13,2022-04-08 15:25:13
"2b9ff7a3-5404-4682-99c7-e426c29af34d",5,12,-7,0.0549450549450549,9,4,13,"Positive","Plejecenter skal være flygtningecenter for ukrainere (2b9ff7a3-5404-4682-99c7-e426c29af34d)",2022-04-08 08:00:51,2022-04-08 08:00:51
"2bbab4cd-9c1e-46b3-a4ce-fd29b7863406",20,30,-10,0.127388535031847,25,6,31,"Positive","Beredskab Fyn om undersøgelse af beskyttelsesrum: - Der er højst sandsynligt ikke nok (2bbab4cd-9c1e-46b3-a4ce-fd29b7863406)",2022-04-10 03:16:53,2022-04-10 03:16:53
"2cde2ee8-1018-4842-8928-9148ac6eaf72",21,35,-14,0.152173913043478,23,8,31,"Positive","Har fået nok efter besparelser for 10 millioner kroner: Nu klager borgere til ombudsmanden (2cde2ee8-1018-4842-8928-9148ac6eaf72)",2022-04-10 09:10:29,2022-04-10 09:10:29
"38cf0f99-1ffc-43e7-9414-d93134263dc7",18,29,-11,0.151260504201681,18,6,24,"Positive","Politikere vil sikre lægehjælp til ukrainske flygtninge (38cf0f99-1ffc-43e7-9414-d93134263dc7)",2022-04-09 05:51:03,2022-04-09 05:51:03
"459d5b19-bab6-4c9e-bdf9-48ff0138e9bd",10,11,-1,0.163934426229508,5,1,6,"Positive","Mandag bliver en lunere dag (459d5b19-bab6-4c9e-bdf9-48ff0138e9bd)",2022-04-11 01:24:06,2022-04-11 01:24:06
"4ee46efb-a700-4520-ab90-8d783b31f6fd",-2,25,-27,-0.016260162601626,13,18,31,"Negative","OB-cheftræner om sen udligning: Betyder utrolig meget (4ee46efb-a700-4520-ab90-8d783b31f6fd)",2022-04-10 13:44:58,2022-04-10 13:44:58
"519e8168-ed53-482a-aa68-308675a12be8",17,31,-14,0.128787878787879,17,9,26,"Positive","Fynske familier vil af med indlogerede ukrainere (519e8168-ed53-482a-aa68-308675a12be8)",2022-04-08 13:10:10,2022-04-08 13:10:10
"536290c2-39ac-4cb0-a5b9-86156920a48b",9,23,-14,0.0588235294117647,16,9,25,"Positive","Gammelt tag bliver til nye gangbroer: Materialemangel sætter skub i genbruget (536290c2-39ac-4cb0-a5b9-86156920a48b)",2022-04-09 05:18:47,2022-04-09 05:18:47
"6d1d4860-1007-42ae-9316-b8ec09828370",9,22,-13,0.0882352941176471,16,10,26,"Positive","Gustav får 13.000 kroner tilbage i skat: Se, hvor mange penge fynboerne i alt skal have tilbage (6d1d4860-1007-42ae-9316-b8ec09828370)",2022-04-08 10:29:02,2022-04-08 10:29:02
"90b6672b-e02f-4b85-9ef0-dd15ed6f2e89",18,44,-26,0.0972972972972973,29,19,48,"Positive","Rock Nalle får museum: - Der er en ting eller to, jeg kunne have undværet (90b6672b-e02f-4b85-9ef0-dd15ed6f2e89)",2022-04-10 15:23:09,2022-04-10 15:23:09
"96f37867-5ffb-46b1-830e-5074b0f84e64",11,31,-20,0.0705128205128205,21,14,35,"Positive","Kommuner kan mangle medarbejdere - også på Fyn (96f37867-5ffb-46b1-830e-5074b0f84e64)",2022-04-11 03:41:19,2022-04-11 03:41:19
"a780fc61-d96c-42b1-b26f-2a833ca3ffc5",15,21,-6,0.319148936170213,12,5,17,"Positive","Sønderjyske - OB: Minut for minut (a780fc61-d96c-42b1-b26f-2a833ca3ffc5)",2022-04-10 11:56:00,2022-04-10 09:53:12
"b4966d19-ffc7-4933-84d2-1bec0365439c",21,28,-7,0.166666666666667,20,6,26,"Positive","Efter storm af støjklager: Letbanen henter udenlandske eksperter til byen (b4966d19-ffc7-4933-84d2-1bec0365439c)",2022-04-09 08:37:17,2022-04-09 08:37:17
"c0292861-8aab-49df-901e-e0b2a174b897",5,20,-15,0.0657894736842105,12,8,20,"Positive","Fyn får blæsende og kold palmesøndag (c0292861-8aab-49df-901e-e0b2a174b897)",2022-04-10 04:14:17,2022-04-10 04:14:17
"c1e7c9ef-be01-409a-aa0c-42d4379800bf",-16,28,-44,-0.105960264900662,17,22,39,"Negative","Klager over kommune til ombudsmanden: - Jeg har hverken kræfter eller overskud til at være der for mit syge barn (c1e7c9ef-be01-409a-aa0c-42d4379800bf)",2022-04-10 14:26:36,2022-04-10 14:26:36
"c6c5def4-75d6-4a04-852d-0b4fd0346cbe",13,23,-10,0.10077519379845,17,8,25,"Positive","Vil slå sin egen rekord: Kro serverer 1.200 schnitzler på én aften (c6c5def4-75d6-4a04-852d-0b4fd0346cbe)",2022-04-08 17:30:13,2022-04-08 17:30:13
"c6d88cae-9492-4d7b-97dc-344d11470c91",38,41,-3,0.306451612903226,28,3,31,"Positive","Omfattende omlægning til fjernvarme kan tage op mod syv år (c6d88cae-9492-4d7b-97dc-344d11470c91)",2022-04-10 07:28:40,2022-04-10 07:28:40
"d173267f-e36f-4890-a499-ebfe1082f925",9,12,-3,0.183673469387755,7,2,9,"Positive","Økokøer kom begejstrede på græs (d173267f-e36f-4890-a499-ebfe1082f925)",2022-04-11 02:19:55,2022-04-11 02:19:55
"dd3bca39-482e-4e32-b119-29debf04e4dc",-1,22,-23,-0.00909090909090909,13,13,26,"Negative","Dusør på 20.000 kr.: 22 kanoer stjålet fra aafarten (dd3bca39-482e-4e32-b119-29debf04e4dc)",2022-04-09 11:11:56,2022-04-09 11:11:56
"ed016c01-1926-4b3e-b3e8-67a2d3c8e8a3",3,17,-14,0.0294117647058824,10,10,20,"Positive","OB fik uafgjort med hjem fra Haderslev (ed016c01-1926-4b3e-b3e8-67a2d3c8e8a3)",2022-04-10 12:02:03,2022-04-10 12:02:03
"f89d20f4-3751-406c-8735-2df23ccb6b5d",-6,19,-25,-0.0405405405405405,14,16,30,"Negative","9. april? - Det siger mig ikke det store (f89d20f4-3751-406c-8735-2df23ccb6b5d)",2022-04-09 16:05:51,2022-04-09 16:05:51
"342ed2b8-35b1-4940-9a01-fd0d0925bc2a",4,18,-14,0.0412371134020619,12,9,21,"Positive","Med statsstøtte i ryggen: Hotel Nyborg Strand fik overskud trods covid-krise (342ed2b8-35b1-4940-9a01-fd0d0925bc2a)",2022-04-07 18:53:56,2022-04-07 18:53:56
"3b8f3c57-5ece-4bae-b044-7914c1440397",5,18,-13,0.0480769230769231,13,10,23,"Positive","Se hele udsendelsen: Sådan undgår du at blive ramt af prisstigningerne (3b8f3c57-5ece-4bae-b044-7914c1440397)",2022-04-07 13:01:13,2022-04-07 13:01:13
"3d125ab6-aeb6-4192-969f-a89d83939022",2,13,-11,0.0150375939849624,10,8,18,"Positive","Fodbold-EM i Odense: - Vi regner med fyldte tribuner (3d125ab6-aeb6-4192-969f-a89d83939022)",2022-04-08 04:55:02,2022-04-08 04:55:02
"56f93594-3497-40b1-9a59-c3f1478148f2",46,65,-19,0.308724832214765,36,13,49,"Positive","84-årige Karl arbejder stadig i børnehaven: - Jeg kan se, børnene vokser, når vi laver noget sammen (56f93594-3497-40b1-9a59-c3f1478148f2)",2022-04-08 01:24:17,2022-04-08 01:24:17
"7886993c-2454-4670-9532-1f3c21cceae8",-4,12,-16,-0.0338983050847458,9,9,18,"Negative","En våd og blæsende fredag - risiko for vindstød af stormstyrke (7886993c-2454-4670-9532-1f3c21cceae8)",2022-04-08 03:23:08,2022-04-08 03:23:08
"91a73d3e-1ec2-4cca-8bd7-10911e9dbc08",28,34,-6,0.207407407407407,27,5,32,"Positive","Ja til kæmpe hoteludvidelse: - Det holder ikke at transportere gæster rundt i busser (91a73d3e-1ec2-4cca-8bd7-10911e9dbc08)",2022-04-07 16:45:00,2022-04-07 16:45:00
"93a936c3-10c5-4dc4-90e6-2d48a88dc79d",33,87,-54,0.0783847980997625,59,32,91,"Positive","Kinesisk dansetrup i Odense: - Shen Yun er en del af topstyret ultrahøjreorienteret sekt (93a936c3-10c5-4dc4-90e6-2d48a88dc79d)",2022-04-07 15:24:06,2022-04-07 15:24:06
"9b2ba3fa-6330-48f8-948a-fd428065b15a",-5,13,-18,-0.0495049504950495,9,11,20,"Negative","Advokat kalder tvangsfjernelse på Langeland kidnapning (9b2ba3fa-6330-48f8-948a-fd428065b15a)",2022-04-07 09:36:18,2022-04-07 09:36:18
"b5baf4cf-b1cb-45aa-bcf3-3b6568294625",3,7,-4,0.0348837209302326,6,3,9,"Positive","Restaurant solgte genbrugskebab: - Det er tydeligt, at kebabspyddet allerede har været anvendt (b5baf4cf-b1cb-45aa-bcf3-3b6568294625)",2022-04-07 07:06:04,2022-04-07 07:06:04
"c6dcb7d0-2dfd-4653-91b8-e13cb0e35701",5,26,-21,0.0316455696202532,18,14,32,"Positive","Formand for letbanen: - Hvis det er uforsvarligt at starte, starter vi ikke (c6dcb7d0-2dfd-4653-91b8-e13cb0e35701)",2022-04-07 17:43:26,2022-04-07 17:43:26
"c84698d3-04ad-46dc-8d2e-5a59971e4ecc",4,5,-1,0.181818181818182,2,1,3,"Positive","Priserne stiger, SU'en er den samme - skal den følge med? (c84698d3-04ad-46dc-8d2e-5a59971e4ecc)",2022-04-07 10:57:52,2022-04-07 10:57:52
"cf929960-fb1a-4013-b393-a0b14e6f5ac2",11,20,-9,0.0964912280701754,13,7,20,"Positive","Se billederne: Sådan bliver Odense Stadion klar til EM (cf929960-fb1a-4013-b393-a0b14e6f5ac2)",2022-04-07 13:48:21,2022-04-07 13:48:21
"05d6f9fe-19ab-45d1-9b2b-89db3110c76e",0,8,-8,0,7,7,14,"Negative","Foråret venter til næste uge: Torsdag fortsætter det regnfulde vejr (05d6f9fe-19ab-45d1-9b2b-89db3110c76e)",2022-04-07 01:41:18,2022-04-07 01:41:18
"10482ec2-0516-4795-9696-bb551be7e471",5,10,-5,0.078125,6,3,9,"Positive","Flere vil dyrke motion - men i Tommerup bliver de ældre væk (10482ec2-0516-4795-9696-bb551be7e471)",2022-04-06 18:25:16,2022-04-06 18:25:16
"2307b174-0272-4b70-a0af-513348adf0ac",19,40,-21,0.0805084745762712,29,20,49,"Positive","Fire gode råd: Sådan får du budgettet til at slå til (2307b174-0272-4b70-a0af-513348adf0ac)",2022-04-06 15:54:48,2022-04-06 15:54:48
"2e1130cb-5313-4841-a69a-5ca3eaf6425a",54,90,-36,0.264705882352941,59,24,83,"Positive","Kommune får kritik for 'uvildig' undersøgelse - borgmester afviser problemer (2e1130cb-5313-4841-a69a-5ca3eaf6425a)",2022-04-06 14:05:01,2022-04-06 14:05:01
"935c0a74-469a-4c53-9e34-81f3389d3484",3,19,-16,0.0297029702970297,11,11,22,"Positive","Odense kan blive EM-værtsby i 2025 (935c0a74-469a-4c53-9e34-81f3389d3484)",2022-04-06 08:08:52,2022-04-06 08:08:52
"9cebd6b9-ffd6-4441-afa4-e91b5cd04cd7",54,56,-2,0.439024390243902,30,2,32,"Positive","Årets Ø er kåret - og den er fynsk (9cebd6b9-ffd6-4441-afa4-e91b5cd04cd7)",2022-04-06 09:15:24,2022-04-06 09:15:24
"b9ad8b0b-1a26-4108-8538-eff03d7a7124",4,24,-20,0.0235294117647059,17,14,31,"Positive","Trods protester: Flertal vil bygge etagebyggeri i unikt boligområde (b9ad8b0b-1a26-4108-8538-eff03d7a7124)",2022-04-06 14:35:00,2022-04-06 11:27:03
"cb29a223-458a-4c0f-9d50-bc621acede57",18,44,-26,0.0676691729323308,30,19,49,"Positive","Priserne stiger og stiger - og det bliver de formentlig ved med (cb29a223-458a-4c0f-9d50-bc621acede57)",2022-04-06 12:37:31,2022-04-06 12:37:31
"d31877ce-3c84-4c8d-b3b1-d8acaea0f313",-1,4,-5,-0.0121951219512195,3,3,6,"Negative","Mange på offentligt forsørgelse flytter til Langeland (d31877ce-3c84-4c8d-b3b1-d8acaea0f313)",2022-04-07 02:59:46,2022-04-07 02:59:46
"deb1b047-2a1b-4694-a296-cdefb0f3eadb",15,27,-12,0.0903614457831325,18,7,25,"Positive","Omstridt byggeri rykker tættere på: - De er fløjtende ligeglade med alt, der hedder borgerinddragelse (deb1b047-2a1b-4694-a296-cdefb0f3eadb)",2022-04-07 04:54:34,2022-04-07 04:54:34
"e3345f2e-cc74-4ac8-85fa-746428184234",6,12,-6,0.0545454545454545,8,6,14,"Positive","Odenses håndboldkvinder buldrer sig tættere på semifinalen (e3345f2e-cc74-4ac8-85fa-746428184234)",2022-04-06 17:06:52,2022-04-06 17:06:52
"055508b3-b59a-45c6-8fe0-dc69f8730a17",0,7,-7,0,5,4,9,"Negative","Onsdagen bliver drivvåd: Her kan fynboerne få regn, slud og tøsne (055508b3-b59a-45c6-8fe0-dc69f8730a17)",2022-04-06 02:05:58,2022-04-06 02:05:58
"1ccac5ea-852d-4b5a-a990-0869850872fe",-6,32,-38,-0.0285714285714286,27,20,47,"Negative","Uvildigt firma skal undersøge ""syg kultur"" - men er knapt så uvildig, viser det sig (1ccac5ea-852d-4b5a-a990-0869850872fe)",2022-04-06 01:24:06,2022-04-06 01:24:06
"3159397d-b8a2-42dc-a95b-36557976cd48",6,18,-12,0.0714285714285714,10,9,19,"Positive","GOG videre til kvartfinale i European League (3159397d-b8a2-42dc-a95b-36557976cd48)",2022-04-05 16:37:47,2022-04-05 16:37:47
"41972709-9aeb-42ba-9f2b-4c9163ebcf0e",27,52,-25,0.127962085308057,36,15,51,"Positive","Fynsk virksomhed ser ind i fremtiden: - Vi skal gøre tingene klogere og mere intelligent (41972709-9aeb-42ba-9f2b-4c9163ebcf0e)",2022-04-05 17:02:57,2022-04-05 17:02:57
"71f26f51-a006-42c6-9dbc-2873e24878b2",5,18,-13,0.0308641975308642,15,10,25,"Positive","Odense Letbane inden byggeri: - Støjdæmpende ruder er ikke nødvendige (71f26f51-a006-42c6-9dbc-2873e24878b2)",2022-04-05 15:07:44,2022-04-05 15:07:44
"a537e0d8-bc51-4bb2-bf8f-0fac3fa75a3e",23,34,-11,0.23469387755102,21,7,28,"Positive","GOG-direktør ser positivt på Aalborgs oprustning (a537e0d8-bc51-4bb2-bf8f-0fac3fa75a3e)",2022-04-05 16:25:08,2022-04-05 16:25:08
"abe6346e-37db-4f5e-8f32-c5f66f6672d5",-22,58,-80,-0.0583554376657825,45,46,91,"Negative","To år efter mistanke om censur: Nu optræder Shen Yun i Odense (abe6346e-37db-4f5e-8f32-c5f66f6672d5)",2022-04-06 03:29:58,2022-04-06 03:29:58
"bbcbdb07-ee31-4c12-a52d-57af31e380af",-4,18,-22,-0.0300751879699248,11,12,23,"Negative","Hotelgæster klager over støj fra letbanen: - Det lyder som et tordenvejr (bbcbdb07-ee31-4c12-a52d-57af31e380af)",2022-04-05 18:21:41,2022-04-05 18:21:41
"c062c08c-f36c-4ef6-b883-6132dbeb220b",-15,7,-22,-0.110294117647059,7,14,21,"Negative","Friskoler lider under stigende gaspriser (c062c08c-f36c-4ef6-b883-6132dbeb220b)",2022-04-06 05:25:13,2022-04-06 05:25:13
"c23fd94a-864f-49eb-82b9-ee9f47c93d84",-2,29,-31,-0.0150375939849624,16,26,42,"Negative","Kathja kæmper for mere i SU - har to jobs for at få økonomien til at række (c23fd94a-864f-49eb-82b9-ee9f47c93d84)",2022-04-05 13:39:05,2022-04-05 13:39:05
"aa5f13c1-e5ec-46d6-ad6d-1971c0700d9c",-18,6,-24,-0.290322580645161,4,13,17,"Negative","Knallert-strid endte i balle-stik (aa5f13c1-e5ec-46d6-ad6d-1971c0700d9c)",2022-04-05 17:55:21,2022-04-05 17:55:21
"aff8e819-85dc-4969-87a3-c8dea993e141",-22,6,-28,-0.282051282051282,4,14,18,"Negative","19-årig skuddræbt: Fyns Politi efterlyser viden om flugtbil (aff8e819-85dc-4969-87a3-c8dea993e141)",2022-04-05 11:27:49,2022-04-05 11:27:49
"3f2dc13e-59b3-4e13-be20-2601242ddd83",-5,29,-34,-0.037037037037037,22,19,41,"Negative","Bandemedlemmer undgår kontrol med proforma-flytninger (3f2dc13e-59b3-4e13-be20-2601242ddd83)",2022-04-05 10:59:53,2022-04-05 10:59:53
"6209007a-e16c-4dcc-bf58-29f212ab05d0",5,7,-2,0.0769230769230769,3,2,5,"Positive","For fjerde år i træk: Årets første bøg er sprunget ud på Fyn (6209007a-e16c-4dcc-bf58-29f212ab05d0)",2022-04-05 07:49:41,2022-04-05 07:49:41
"0a3d1bf5-494d-40fc-9325-1b1c593b3c8f",12,16,-4,0.0923076923076923,13,4,17,"Positive","Museum finder hemmelige skatte i baghaven (0a3d1bf5-494d-40fc-9325-1b1c593b3c8f)",2022-03-31 13:31:49,2022-03-31 13:31:49
"2bd64e2b-3e41-4a4c-967b-d89a262aa63f",19,45,-26,0.085972850678733,25,17,42,"Positive","Ny læreruddannelse udfordret: - Når vi får dem indenfor, bliver de (2bd64e2b-3e41-4a4c-967b-d89a262aa63f)",2022-04-05 04:11:19,2022-04-05 04:11:19
"47e8c20f-29b0-423a-9630-71a8db616044",-6,16,-22,-0.0437956204379562,12,18,30,"Negative","Letbanen i Odense: Støj kan godt påvirke sundheden, vurderer læge (47e8c20f-29b0-423a-9630-71a8db616044)",2022-04-04 18:41:07,2022-04-04 18:41:07
"52d837c3-d736-4cca-b963-16fa8176e452",-8,15,-23,-0.0714285714285714,11,14,25,"Negative","Bulldogs ude af DM-kampen (52d837c3-d736-4cca-b963-16fa8176e452)",2022-04-04 17:44:33,2022-04-04 17:44:33
"784d381d-ff69-4597-8dbc-8ab6303a768f",37,41,-4,0.385416666666667,22,3,25,"Positive","Fynske Guldimund: - Skøn følelse, at blive råbt op i så fint selskab (784d381d-ff69-4597-8dbc-8ab6303a768f)",2022-04-04 16:09:48,2022-04-04 16:09:48
"98640d71-2980-436c-b663-63c49fe1feed",1,15,-14,0.0128205128205128,9,10,19,"Positive","Mildere vejr tirsdag - men nyd det, mens det varer (98640d71-2980-436c-b663-63c49fe1feed)",2022-04-05 02:26:27,2022-04-05 02:26:27
"01a6325b-ef0f-4015-bf46-76ba00074d6e",39,45,-6,0.23780487804878,30,5,35,"Positive","Ny urban bydel med sociale fællesskaber skal skabe mere liv i centrum (01a6325b-ef0f-4015-bf46-76ba00074d6e)",2022-03-25 15:26:08,2022-03-25 15:26:08
"042ab3aa-ecb3-46ab-ab58-a8db254ca0d7",6,15,-9,0.0465116279069767,13,7,20,"Positive","Fynbo alligevel udtaget til Flandern Rundt (042ab3aa-ecb3-46ab-ab58-a8db254ca0d7)",2022-04-02 08:46:57,2022-04-02 08:46:57
"074591a8-7f52-44f9-b213-628236ac74ee",6,19,-13,0.0363636363636364,14,9,23,"Positive","110 eller 130 kilometer i timen? Lavere fartgrænser splitter bilister på Fynske Motorvej (074591a8-7f52-44f9-b213-628236ac74ee)",2022-03-26 17:39:55,2022-03-26 17:39:55
"080c9e1a-b778-4595-b9f2-9511819654ee",-9,6,-15,-0.138461538461538,4,8,12,"Negative","Her er der faldet 15 centimeter sne på Fyn (080c9e1a-b778-4595-b9f2-9511819654ee)",2022-03-30 18:28:35,2022-03-30 18:28:35
"0b75e17b-5ad3-4cfa-989a-14917ef613df",4,6,-2,0.129032258064516,5,2,7,"Positive","Pia Kjærsgaard ny sosu-lærer: Her er nogle af de fynske aprilsnarre (0b75e17b-5ad3-4cfa-989a-14917ef613df)",2022-04-01 16:18:02,2022-04-01 16:18:02
"0e91822e-e395-42b7-8c18-81ef6c8db5bd",24,36,-12,0.135593220338983,24,9,33,"Positive","Strynø i finalen til Årets Ø: 'De ligger lunt i svinget' (0e91822e-e395-42b7-8c18-81ef6c8db5bd)",2022-03-23 20:40:32,2022-03-23 20:40:32
"11f57ee7-3f94-45a0-9db9-35c42a0ce779",15,27,-12,0.132743362831858,17,10,27,"Positive","Jobbanker med studerende skal sikre hænder til ukrainere (11f57ee7-3f94-45a0-9db9-35c42a0ce779)",2022-04-02 17:53:40,2022-04-02 17:53:40
"1338b2f4-6bd2-4a6e-a419-0aa80e17f87d",8,25,-17,0.0418848167539267,19,9,28,"Positive","Arbejdere bedt om at spise svinekød fra altan: - Det er kvalmende og uacceptabelt (1338b2f4-6bd2-4a6e-a419-0aa80e17f87d)",2022-03-28 16:37:52,2022-03-28 16:37:52
"15e34422-e072-4eda-8aa6-bd0dc54bcb1a",5,24,-19,0.0403225806451613,14,9,23,"Positive","Rådmand kritiseres for forslag om 40 km/t-zone: - Det er ikke for at genere nogen (15e34422-e072-4eda-8aa6-bd0dc54bcb1a)",2022-03-28 11:48:19,2022-03-28 11:48:19
"172ba1cf-3b6d-4c2d-b306-4659f3bdcc06",-4,8,-12,-0.0714285714285714,4,7,11,"Negative","Se billederne: Sneen daler over Fyn (172ba1cf-3b6d-4c2d-b306-4659f3bdcc06)",2022-03-30 09:41:49,2022-03-30 09:41:49
"17e22639-9db0-4593-ba91-4c93a41e840c",20,26,-6,0.222222222222222,15,5,20,"Positive","Odense Aafart fejrer 140 år: Nu skal bådene på el (17e22639-9db0-4593-ba91-4c93a41e840c)",2022-04-02 05:36:03,2022-04-02 05:36:03
"19bbfd40-9068-4fa2-9aa7-3800d60f413f",13,19,-6,0.125,12,5,17,"Positive","Landsholdskammerat før muligt Eriksen-comeback: - Han er fuldstændig sig selv (19bbfd40-9068-4fa2-9aa7-3800d60f413f)",2022-03-26 09:51:49,2022-03-26 09:51:49
"1dcf65f2-4708-4774-b570-9bf0362a5106",8,19,-11,0.0909090909090909,9,10,19,"Positive","Vigtig sejr: Dobbelt-Breum scoring sikrer OB-sejr over FC Nordsjælland (1dcf65f2-4708-4774-b570-9bf0362a5106)",2022-04-03 14:12:49,2022-04-03 14:12:49
"1e28dcfb-550e-4c8a-90d9-2ecefeb99405",-11,5,-16,-0.135802469135802,4,10,14,"Negative","Andet uheld på to dage: Letbanesammenstød lukkede trafikeret vej (1e28dcfb-550e-4c8a-90d9-2ecefeb99405)",2022-03-23 16:47:36,2022-03-23 16:47:36
"1f94a00b-3c22-449f-84d6-8b23bb3a3515",36,46,-10,0.230769230769231,27,8,35,"Positive","Bliver udfordret på Danmarks bedste romkugle: - Det vil altid være romkuglerne fra Nørre Aaby (1f94a00b-3c22-449f-84d6-8b23bb3a3515)",2022-03-28 18:46:58,2022-03-28 18:46:58
"1aa44b95-36ba-4afe-8b54-cbc0142dacc0",32,36,-4,0.222222222222222,27,4,31,"Positive","Ny filmuddannelse er på vej til Fyn (1aa44b95-36ba-4afe-8b54-cbc0142dacc0)",2022-03-27 05:35:28,2022-03-27 05:35:28
"20f65124-8307-4ad4-b35a-11006266fcfe",28,41,-13,0.184210526315789,25,9,34,"Positive","Eriksen: Jeg kender årsagen til mit kollaps (20f65124-8307-4ad4-b35a-11006266fcfe)",2022-03-24 09:43:53,2022-03-24 09:43:53
"22f75155-11e4-4447-b566-47c1d19ca9c3",13,28,-15,0.0860927152317881,19,12,31,"Positive","Da Pytlick blev fyret som landstræner, sagde hans børn noget, der ramte ham (22f75155-11e4-4447-b566-47c1d19ca9c3)",2022-03-26 14:16:07,2022-03-26 14:16:07
"236e7c44-18ca-48cc-ac32-e67b54573dd6",-2,19,-21,-0.0155038759689922,16,13,29,"Negative","Odenseanere uopmærksomme på letbanen: - Det var 15 sekunder fra mig, så det var tæt på (236e7c44-18ca-48cc-ac32-e67b54573dd6)",2022-03-31 04:17:28,2022-03-31 04:17:28
"24660fe4-4c71-476b-a129-37b34d0af7f3",21,35,-14,0.106060606060606,25,10,35,"Positive","Ladestander-ørken: Nu får Faaborg-Midtfyn lov at hjælpe elbiler på vej (24660fe4-4c71-476b-a129-37b34d0af7f3)",2022-03-27 13:01:17,2022-03-27 13:01:17
"25271a4b-f071-4340-8871-232607e4c3bf",-3,8,-11,-0.036144578313253,7,6,13,"Negative","Ekstraordinært højt tal: Så mange gange har letbanen været tæt på sammenstød (25271a4b-f071-4340-8871-232607e4c3bf)",2022-03-30 05:49:55,2022-03-30 05:49:55
"2599e90b-7ec1-476c-af1b-7efc57cf143d",2,10,-8,0.0202020202020202,8,5,13,"Positive","Kortere pendlertur i bil 200 kroner dyrere per måned siden nytår (2599e90b-7ec1-476c-af1b-7efc57cf143d)",2022-03-27 07:18:11,2022-03-27 07:18:11
"25c85d15-08f8-4d96-bc80-6432fde1388a",-7,10,-17,-0.0666666666666667,10,11,21,"Negative","Letbaneformand om støjgener: - Jeg synes ikke, den larmer så meget (25c85d15-08f8-4d96-bc80-6432fde1388a)",2022-04-01 15:01:29,2022-04-01 15:01:29
"28522acb-2098-426c-8ca4-caa7a977f77b",17,34,-17,0.105590062111801,23,8,31,"Positive","Ny, stor kulturfest på Fyn: - En sanselig kulturoplevelse (28522acb-2098-426c-8ca4-caa7a977f77b)",2022-03-25 05:19:39,2022-03-25 05:19:39
"28c0598e-7320-4989-bba0-a8e564d9ff04",-7,37,-44,-0.0434782608695652,26,34,60,"Negative","Sådan undgår du ulykker: Højsæson for hjortepåkørsler (28c0598e-7320-4989-bba0-a8e564d9ff04)",2022-03-23 07:35:59,2022-03-23 07:35:59
"306d53cf-7b6b-4e76-b0c1-9b75077d4409",13,31,-18,0.087248322147651,20,14,34,"Positive","Minister bøjer sig for kvægavlere: Nu må dyrene igen slagtes på marken (306d53cf-7b6b-4e76-b0c1-9b75077d4409)",2022-03-30 13:10:47,2022-03-30 13:10:47
"315394b4-3eee-44ef-bce1-a4de6836ff7e",4,10,-6,0.0533333333333333,8,3,11,"Positive","Syddanmark sender flere ambulancer til Ukraine (315394b4-3eee-44ef-bce1-a4de6836ff7e)",2022-03-23 15:03:18,2022-03-23 15:03:18
"3498c1ab-9b33-4ef2-a80a-c8b1c68be5e0",-13,3,-16,-0.203125,3,7,10,"Negative","Flugtbilist efterlyst for at påkøre to personer på fortov (3498c1ab-9b33-4ef2-a80a-c8b1c68be5e0)",2022-04-03 05:34:44,2022-04-03 05:34:44
"36074e11-72c5-4309-9d93-4f47f1e78c7c",10,19,-9,0.0645161290322581,13,7,20,"Positive","Langeland mangler 20 akuthjælpere: - Er der ingen frivillige, er der ingen hjælp (36074e11-72c5-4309-9d93-4f47f1e78c7c)",2022-03-29 20:04:27,2022-03-29 20:04:27
"362b0d9a-b782-4a9d-917b-650f79467620",-7,1,-8,-0.102941176470588,1,5,6,"Negative","Mor og datter ramt af bil - fireårig pige i kritisk tilstand (362b0d9a-b782-4a9d-917b-650f79467620)",2022-03-22 20:40:00,2022-03-22 19:07:19
"36b91bef-4a1f-44c0-9819-dbb78fe1a31f",7,15,-8,0.116666666666667,6,5,11,"Positive","Se billederne: Solrig dag i vente onsdag (36b91bef-4a1f-44c0-9819-dbb78fe1a31f)",2022-03-23 05:45:29,2022-03-23 05:45:29
"36e1a90b-6e31-4471-a2ed-286482c1cf89",-1,27,-28,-0.00740740740740741,21,18,39,"Negative","Letbane-uheld kommer ikke bag på ekspert: - Vi så det også med elcyklerne (36e1a90b-6e31-4471-a2ed-286482c1cf89)",2022-03-25 08:27:06,2022-03-25 08:27:06
"396ecb67-c214-4898-90a4-17293beef1fd",9,20,-11,0.076271186440678,12,9,21,"Positive","GOG-træner før Final 4: Vi skal være 20-25 procent bedre (396ecb67-c214-4898-90a4-17293beef1fd)",2022-03-26 11:32:47,2022-03-26 11:32:47
"3caafe99-7ce8-4861-844d-ecb2de21e148",50,61,-11,0.333333333333333,33,9,42,"Positive","Opgør på Vestfyn: Rikke vil udfordre Nørre Aaby i kampen om Danmarks bedste romkugle (3caafe99-7ce8-4861-844d-ecb2de21e148)",2022-03-28 14:57:31,2022-03-28 14:57:31
"3eed72a6-9054-4d69-abaa-41f1c63574b2",0,17,-17,0,14,12,26,"Negative","Krigsbekymring hos borgere: Kommuner skal lave lister over beskyttelsesrum (3eed72a6-9054-4d69-abaa-41f1c63574b2)",2022-03-28 20:01:11,2022-03-28 20:01:11
"3f84797e-2596-43a6-aedc-9e7be30b1fb0",40,40,0,0.298507462686567,25,0,25,"Positive","Derfor kan Strynø blive Årets Ø: - Man er strynbo, når man flytter sin adresse til Strynø (3f84797e-2596-43a6-aedc-9e7be30b1fb0)",2022-03-25 12:19:18,2022-03-25 12:19:18
"408bb3f2-8230-4586-840b-0dfc49b92882",4,9,-5,0.1,7,4,11,"Positive","Fra vintertid til sommertid: I nat skal du stille uret en time frem (408bb3f2-8230-4586-840b-0dfc49b92882)",2022-03-26 18:14:47,2022-03-26 18:14:47
"40f9d58c-6390-4dbf-9b7b-d910f560e887",1,14,-13,0.00980392156862745,10,8,18,"Positive","Chef videregav fortrolige oplysninger i børnesag til nabo (40f9d58c-6390-4dbf-9b7b-d910f560e887)",2022-03-23 14:43:48,2022-03-23 14:43:48
"41be31e7-8b1f-470f-8e96-61a8ce55f6ab",-26,24,-50,-0.180555555555556,18,28,46,"Negative","Knastør marts giver høj risiko for naturbrand - sådan undgår du det (41be31e7-8b1f-470f-8e96-61a8ce55f6ab)",2022-03-26 11:17:16,2022-03-26 11:17:16
"42158b12-9208-4694-96d3-b254a4fa5803",0,12,-12,0,7,7,14,"Negative","Letbanens testkørsel larmer: Har modtaget 80 støjklager den seneste måned (42158b12-9208-4694-96d3-b254a4fa5803)",2022-04-01 10:04:31,2022-04-01 10:04:31
"42870c5e-6d54-4e0f-9479-6d69ba5c391c",-15,5,-20,-0.15,5,12,17,"Negative","Se tallene for din kommune: Færre boliger til salg på Fyn (42870c5e-6d54-4e0f-9479-6d69ba5c391c)",2022-04-04 14:53:50,2022-04-04 14:53:50
"4289013b-e89c-46ee-b2f7-321df5603289",-1,5,-6,-0.0175438596491228,5,5,10,"Negative","Tirsdag skrues der ned for temperaturen (4289013b-e89c-46ee-b2f7-321df5603289)",2022-03-29 05:42:46,2022-03-29 05:42:46
"43495c5d-2ead-4382-8faf-0532522a750c",-2,8,-10,-0.021978021978022,6,6,12,"Negative","Snevejr skyld i flere uheld: - Det er lige tidligt nok med sommerdæk (43495c5d-2ead-4382-8faf-0532522a750c)",2022-03-31 11:03:49,2022-03-31 11:03:49
"43c3d742-45f2-497d-b1bd-4d9d5e18b4b3",20,26,-6,0.170940170940171,18,5,23,"Positive","Stor forskel i kommuners hjælp til ukrainske flygtninge og danske værter (43c3d742-45f2-497d-b1bd-4d9d5e18b4b3)",2022-04-02 18:07:51,2022-04-02 18:07:51
"449c552b-955f-415d-bc26-144f710c390d",23,36,-13,0.17037037037037,18,8,26,"Positive","Romkuglekongen fra Nørre Aaby har ikke længere Danmarks bedste romkugler (449c552b-955f-415d-bc26-144f710c390d)",2022-03-29 17:55:04,2022-03-29 17:55:04
"46c54bd9-f464-4300-b9c2-3fb8feed9c41",-4,22,-26,-0.0408163265306122,18,14,32,"Negative","Firma anker dom mod Odense Havn: - Det strider mod vores retsfølelse (46c54bd9-f464-4300-b9c2-3fb8feed9c41)",2022-03-25 17:00:42,2022-03-25 17:00:42
"47692c14-e92b-4ed4-8cdd-cb2ffe4b2b90",-1,18,-19,-0.0087719298245614,13,10,23,"Negative","Få lademuligheder i Faaborg-Midtfyn: - Uden privat ladestander er man ""lost"" (47692c14-e92b-4ed4-8cdd-cb2ffe4b2b90)",2022-03-27 18:00:42,2022-03-27 18:00:42
"48e7ad40-7ca1-42e8-a450-a9be5a751647",-20,1,-21,-0.266666666666667,1,9,10,"Negative","Dræbt på parkeringsplads i Odense: Politiet sigter 23-årig for medvirken (48e7ad40-7ca1-42e8-a450-a9be5a751647)",2022-04-04 09:54:47,2022-04-04 09:54:47
"4b9b07f0-a68d-4391-929b-2cd40dc85e53",13,27,-14,0.104,18,11,29,"Positive","Charlotte samler ind i kamp mod kræft: - Jeg har en lille søn, så jeg er bange for tilbagefald (4b9b07f0-a68d-4391-929b-2cd40dc85e53)",2022-04-04 03:18:00,2022-04-04 03:18:00
"4ed43b3d-058a-4768-abbf-18a953f9a29a",-2,10,-12,-0.0212765957446809,7,9,16,"Negative","Odense slår Sønderjyske i maratonkamp og booker semifinale (4ed43b3d-058a-4768-abbf-18a953f9a29a)",2022-03-25 21:54:23,2022-03-25 21:54:23
"5082dc25-13aa-4588-8e44-b59dbe0b5065",-4,5,-9,-0.05,4,9,13,"Negative","Føtex og Bilka hæver priserne på tusindvis af varer (5082dc25-13aa-4588-8e44-b59dbe0b5065)",2022-03-28 07:14:17,2022-03-28 07:14:17
"524a51c8-5b65-4976-aaaf-5df45d550d3f",2,25,-23,0.0165289256198347,16,15,31,"Positive","Corona er kun forsmagen på sundhedsvæsenets krise (524a51c8-5b65-4976-aaaf-5df45d550d3f)",2022-03-24 13:44:59,2022-03-24 13:44:59
"53b19cfc-f5c9-464a-99c7-ac66d999cbd7",12,25,-13,0.0764331210191083,15,9,24,"Positive","Det kører på små skinner: Buschaufføren Ib gik på efterløn og blev grebet af modeltogene (53b19cfc-f5c9-464a-99c7-ac66d999cbd7)",2022-03-26 19:10:06,2022-03-26 19:10:06
"543385d5-247c-439b-a110-ba04211071cd",12,26,-14,0.09375,14,9,23,"Positive","Nye uddannelser skaber glæde på Sydfyn, men rekruttering kan blive ""vanskelig"" (543385d5-247c-439b-a110-ba04211071cd)",2022-03-23 18:11:28,2022-03-23 18:11:28
"550975c7-0a46-434b-88c4-d93ad2aa5bef",-5,27,-32,-0.0333333333333333,16,17,33,"Negative","Advokat har ikke tillid til børnesager fra Langeland: Borgmester afviser, at der er et problem (550975c7-0a46-434b-88c4-d93ad2aa5bef)",2022-03-22 16:33:13,2022-03-22 16:33:13
"5589f7e5-f1bf-455a-ba1f-593de7f23a01",5,10,-5,0.0537634408602151,7,3,10,"Positive","Se kortet: Så mange ukrainere er flygtet til din kommune (5589f7e5-f1bf-455a-ba1f-593de7f23a01)",2022-03-29 14:18:56,2022-03-29 14:18:56
"5591aaaf-4309-42af-b310-7ba349d1969f",32,43,-11,0.163265306122449,27,6,33,"Positive","Hanne har to gange haft brug for akuthjælperne: - De kan ikke undværes herude (5591aaaf-4309-42af-b310-7ba349d1969f)",2022-03-29 15:49:31,2022-03-29 15:49:31
"5611c643-8fc0-4b7b-a66f-e3eab2c0dc07",8,14,-6,0.0559440559440559,9,5,14,"Positive","Ude af Champions League: Odense Håndbold taber til Brest Bretagne (5611c643-8fc0-4b7b-a66f-e3eab2c0dc07)",2022-04-03 15:59:09,2022-04-03 15:59:09
"58b15009-9457-46cc-94e6-d43a15013373",-12,10,-22,-0.115384615384615,7,14,21,"Negative","Odense taber første semifinalekamp i overtid (58b15009-9457-46cc-94e6-d43a15013373)",2022-03-29 18:54:13,2022-03-29 18:54:13
"5964f3c2-ed4f-46cb-a727-3e7c086b1e1c",3,8,-5,0.029126213592233,6,5,11,"Positive","Foråret sat på pause - efterårslignende vejr i vente for fynboerne (5964f3c2-ed4f-46cb-a727-3e7c086b1e1c)",2022-04-04 05:12:49,2022-04-04 05:12:49
"59c18aa2-34f3-4036-86c7-885b95ab3983",-9,22,-31,-0.0471204188481675,19,20,39,"Negative","Det kan blive dyrt at genåbne børnesager, hvis der er fejl, siger professor (59c18aa2-34f3-4036-86c7-885b95ab3983)",2022-03-25 18:02:30,2022-03-25 18:02:30
"5a2e1cfd-0909-40a6-bdec-f39b51543a69",14,17,-3,0.184210526315789,9,3,12,"Positive","Hjulmand: Eriksen har sin bedste tid foran sig (5a2e1cfd-0909-40a6-bdec-f39b51543a69)",2022-03-27 05:48:57,2022-03-27 05:48:57
"5cba67aa-6d61-4b99-8fdf-b88347b7e120",16,26,-10,0.216216216216216,13,7,20,"Positive","Smitteopsporingen opsiger næsten alle medarbejdere (5cba67aa-6d61-4b99-8fdf-b88347b7e120)",2022-03-18 12:13:23,2022-03-18 12:13:23
"64285c79-17fe-4f06-a490-e57345795b26",6,18,-12,0.0714285714285714,14,8,22,"Positive","Indsamling på Fyn skal sikre Børnetelefonen for ukrainske flygtninge (64285c79-17fe-4f06-a490-e57345795b26)",2022-03-28 04:13:22,2022-03-28 04:13:22
"660f975e-463f-4bcb-ac16-7a0176266a19",21,32,-11,0.179487179487179,19,7,26,"Positive","Løbsdirektør ser frem til vigtig Nyborg-etape: - Man kan tabe Tour de France på 2. etape (660f975e-463f-4bcb-ac16-7a0176266a19)",2022-03-23 20:15:15,2022-03-23 20:15:15
"6a0bfa81-4b55-450a-89fb-de7d5f00559e",-12,2,-14,-0.148148148148148,2,8,10,"Negative","Fireårig pige afgået ved døden efter trafikulykke i Nyborg (6a0bfa81-4b55-450a-89fb-de7d5f00559e)",2022-03-23 19:12:06,2022-03-23 19:12:06
"6b785b31-5e5c-4744-b12a-f0c7b0d8e621",-4,7,-11,-0.0454545454545455,5,8,13,"Negative","Strømmen er meget billig i eftermiddag (6b785b31-5e5c-4744-b12a-f0c7b0d8e621)",2022-03-28 14:15:11,2022-03-28 14:15:11
"6c0742b7-da5c-4954-a38b-6e63d5416e64",33,34,-1,0.226027397260274,22,1,23,"Positive","Erhvervsmillioner fordelt: 88 millioner kroner til robotindustri på Odense Havn (6c0742b7-da5c-4954-a38b-6e63d5416e64)",2022-03-25 13:49:42,2022-03-25 13:49:42
"6e32ce93-4120-4bc8-9ee4-1f2505b5478a",7,22,-15,0.0729166666666667,13,12,25,"Positive","Forbered din have til sommeren: Bierne har brug for din hjælp (6e32ce93-4120-4bc8-9ee4-1f2505b5478a)",2022-04-01 13:21:16,2022-04-01 13:21:16
"6fdf22b1-1a8d-412d-84b7-93c395652a20",3,9,-6,0.0384615384615385,6,6,12,"Positive","Ni biler fundet på bunden af Odense Havn (6fdf22b1-1a8d-412d-84b7-93c395652a20)",2022-03-25 18:30:10,2022-03-25 18:30:10
"7016145a-99a7-4e35-9692-02d7bfa23bb7",9,21,-12,0.0608108108108108,15,7,22,"Positive","Opsigtsvækkende og dyrt forslag om børnesager: - Der er på ingen måde penge til det, mener redaktør på Langeland (7016145a-99a7-4e35-9692-02d7bfa23bb7)",2022-03-24 16:59:10,2022-03-24 16:59:10
"705bbb20-21c2-4d3b-b30a-5f22807eea07",-13,21,-34,-0.0970149253731343,14,17,31,"Negative","Mere end 14 dages ventetid i borgerservice gør, at flere kan miste adgangen til deres netbank (705bbb20-21c2-4d3b-b30a-5f22807eea07)",2022-03-30 15:34:11,2022-03-30 15:34:11
"73ff83a5-2f15-42e3-bcb2-6161d3f88520",-5,21,-26,-0.0257731958762887,17,18,35,"Negative","Så mange vanvidskøretøjer er beslaglagt på Fyn (73ff83a5-2f15-42e3-bcb2-6161d3f88520)",2022-04-01 06:24:11,2022-04-01 06:24:11
"7566ce98-caf5-4801-9e58-d344d9090129",-5,19,-24,-0.0352112676056338,11,14,25,"Negative","Odense Bulldogs taber stort mod Aalborg (7566ce98-caf5-4801-9e58-d344d9090129)",2022-04-03 15:10:33,2022-04-03 15:10:33
"771092b6-33a5-410d-982f-6016067dd9b7",15,20,-5,0.131578947368421,15,4,19,"Positive","Patrick fandt skjult krypt på kirkegård - nu vil han genskabe den (771092b6-33a5-410d-982f-6016067dd9b7)",2022-03-31 06:01:39,2022-03-31 06:01:39
"7ae94909-bf3a-46dc-86c3-48ee0676d0c3",-14,3,-17,-0.121739130434783,2,15,17,"Negative","Odenses borgmester vil huse ukrainere i Vollsmose (7ae94909-bf3a-46dc-86c3-48ee0676d0c3)",2022-03-25 10:56:58,2022-03-25 10:56:58
"7bb8a717-aaf7-46ad-8326-9f0578c43d90",46,57,-11,0.289308176100629,31,8,39,"Positive","Konditorlandsholdet er klar til EM: - Vi går efter at vinde (7bb8a717-aaf7-46ad-8326-9f0578c43d90)",2022-03-24 07:43:51,2022-03-24 07:43:51
"7cbc56c8-1142-4fd9-85d6-8fdcbde4f66b",2,20,-18,0.0137931034482759,12,17,29,"Positive","I torsdags var meldingen en anden: Regeringen vil huse ukrainere i udsatte boligområder (7cbc56c8-1142-4fd9-85d6-8fdcbde4f66b)",2022-03-26 16:01:31,2022-03-26 16:01:31
"7d19d7d4-eb76-40ff-a962-c4ff926d8231",-10,16,-26,-0.078740157480315,14,15,29,"Negative","Sia reddet fra indre blødninger: Hundeejere skal passe på livsfarlig parasit (7d19d7d4-eb76-40ff-a962-c4ff926d8231)",2022-03-29 12:46:06,2022-03-29 12:46:06
"803f591f-c85b-41e8-a752-acf6557e3c74",31,58,-27,0.129707112970711,34,17,51,"Positive","Kasper Schmeichel: Et landshold uden Lars Høgh er svært (803f591f-c85b-41e8-a752-acf6557e3c74)",2022-03-26 12:31:55,2022-03-26 12:31:55
"80a3838d-f670-43ef-98c0-57c92c3c63da",-2,5,-7,-0.0217391304347826,4,5,9,"Negative","Odense vil tage imod flere ukrainere, end byen er forpligtet til (80a3838d-f670-43ef-98c0-57c92c3c63da)",2022-03-23 19:39:07,2022-03-23 19:39:07
"842b452e-2a9e-474e-8b98-8836b7c1c900",-7,16,-23,-0.053030303030303,13,18,31,"Negative","Byrådsmedlem om husning af ukrainere: - Det vil være en historisk fejl (842b452e-2a9e-474e-8b98-8836b7c1c900)",2022-03-25 14:54:02,2022-03-25 14:54:02
"84b0c190-77be-44dc-ab63-3b352faa0ee6",30,38,-8,0.245901639344262,27,8,35,"Positive","Fyn er film: Disse film blev produceret på Fyn i 2021 (84b0c190-77be-44dc-ab63-3b352faa0ee6)",2022-03-30 14:05:15,2022-03-30 14:05:15
"866147d6-fdfc-4bcb-a100-5d1c6276aecf",15,19,-4,0.170454545454545,10,3,13,"Positive","Middelfart Kirke genåbner efter to års renovering (866147d6-fdfc-4bcb-a100-5d1c6276aecf)",2022-04-03 06:43:40,2022-04-03 06:43:40
"86ec0df7-936c-4ce1-bdbb-6fcdcfc6cc4c",20,25,-5,0.285714285714286,13,3,16,"Positive","Christian Eriksen efter comeback og scoring: Det bliver endnu mere specielt i Parken (86ec0df7-936c-4ce1-bdbb-6fcdcfc6cc4c)",2022-03-27 05:01:22,2022-03-27 05:01:22
"8877532b-4cf9-493a-8832-a1a131d4e8eb",-6,48,-54,-0.0205479452054795,39,30,69,"Negative","Anmeldte forgæves brandtilsyn hos Grønnely: - Det er farligt for beboerne at bo på adressen (8877532b-4cf9-493a-8832-a1a131d4e8eb)",2022-04-04 09:17:56,2022-04-04 09:17:56
"88c5c72c-c9c6-4b33-8bae-91a502dc584a",29,37,-8,0.204225352112676,19,6,25,"Positive","Gods vil bygge grøn ladestander, men Vejdirektoratet siger nej (88c5c72c-c9c6-4b33-8bae-91a502dc584a)",2022-03-31 17:32:05,2022-03-31 17:32:05
"8a517e24-11ac-490c-bf60-e77ff15473ec",25,34,-9,0.18796992481203,18,8,26,"Positive","Odense tager første stik i tæt playoffkamp mod Toft og co. (8a517e24-11ac-490c-bf60-e77ff15473ec)",2022-03-27 15:56:37,2022-03-27 15:56:37
"8c49e61f-234c-426c-9ddb-0d34c0cb4f56",-23,0,-23,-0.343283582089552,0,11,11,"Negative","Truede personalet til at lægge sig på gulvet: Nu har 45-årig røver fået sin dom (8c49e61f-234c-426c-9ddb-0d34c0cb4f56)",2022-03-29 12:08:23,2022-03-29 12:08:23
"8d092eee-2167-4b44-89cb-520e8e448df6",-11,2,-13,-0.174603174603175,2,7,9,"Negative","Risiko for slud og tøsne onsdag (8d092eee-2167-4b44-89cb-520e8e448df6)",2022-03-30 04:43:52,2022-03-30 04:43:52
"8d12b167-c6b2-4b80-a499-b0ba3e3a47a9",5,22,-17,0.0328947368421053,15,13,28,"Positive","GOG taber dramatisk pokalfinale mod Aalborg (8d12b167-c6b2-4b80-a499-b0ba3e3a47a9)",2022-03-27 16:15:30,2022-03-27 16:15:30
"8d22d66b-c354-4714-bd13-f6ff59045b51",-11,3,-14,-0.171875,2,7,9,"Negative","Tredje gang på samme strækning: Letbane og bil igen i nærkontakt (8d22d66b-c354-4714-bd13-f6ff59045b51)",2022-03-30 17:19:12,2022-03-30 17:19:12
"8dd5c82b-4cd8-46b3-afe0-2ad9727af483",-60,21,-81,-0.289855072463768,14,47,61,"Negative","Butikker trætte af gentagne tyverier: - Vi mister mellem 5.000 og 10.000 kroner hver gang (8dd5c82b-4cd8-46b3-afe0-2ad9727af483)",2022-03-24 10:57:31,2022-03-24 10:57:31
"8f6cf355-69d7-468f-bde8-943fe723aee7",-3,18,-21,-0.0236220472440945,10,12,22,"Negative","Se kortet: Her kan det blive forbudt at køre i din dieselbil (8f6cf355-69d7-468f-bde8-943fe723aee7)",2022-03-22 15:44:00,2022-03-22 14:45:52
"907ec33f-6ea5-4da6-8b73-b8a1f5b14f3b",10,23,-13,0.10752688172043,15,10,25,"Positive","Tre scoringer på 24 sekunder skaffer Odense en syvende kamp (907ec33f-6ea5-4da6-8b73-b8a1f5b14f3b)",2022-03-22 19:17:18,2022-03-22 19:17:18
"956376bd-dc21-46c5-b8b9-bbf4dd383d63",19,23,-4,0.11875,16,3,19,"Positive","Grønt lys til største byggeprojekt i Odense i årevis (956376bd-dc21-46c5-b8b9-bbf4dd383d63)",2022-03-23 21:15:13,2022-03-23 21:15:13
"95c2e885-5e0a-4dda-aa8c-194ee4610c9e",5,18,-13,0.0347222222222222,11,8,19,"Positive","Eriksen overvejede aldrig Superligaen (95c2e885-5e0a-4dda-aa8c-194ee4610c9e)",2022-03-25 06:59:48,2022-03-25 06:59:48
"97fbfdc8-fde0-410e-ba63-39089da33574",19,45,-26,0.0822510822510823,29,15,44,"Positive","Akuthjælperen Jacob var med til at redde Anders' liv - i dag er de nære venner (97fbfdc8-fde0-410e-ba63-39089da33574)",2022-03-30 19:09:55,2022-03-30 19:09:55
"980b9d94-7e6d-4316-ab1d-42387c122552",1,8,-7,0.0158730158730159,4,5,9,"Positive","Odense Letbane genhuser støjplaget familie (980b9d94-7e6d-4316-ab1d-42387c122552)",2022-04-01 10:48:44,2022-04-01 10:48:44
"985b84c1-c311-48ef-ad7b-e908cbbdfe9c",-12,24,-36,-0.0638297872340425,16,22,38,"Negative","Politikere om letbane-støj: - Det kan have voldsomme konsekvenser (985b84c1-c311-48ef-ad7b-e908cbbdfe9c)",2022-04-02 14:59:08,2022-04-02 14:59:08
"995a45e8-4cd7-4a9d-aadc-b77a50176622",10,46,-36,0.0595238095238095,28,20,48,"Positive","Ildsjæl åbner pop-up café: Mens ukrainske flygtninge venter på ophold, kan de få gratis kaffe og kram (995a45e8-4cd7-4a9d-aadc-b77a50176622)",2022-04-04 06:15:46,2022-04-04 06:15:46
"99a706d9-56b2-4a71-865c-573cdb5e9939",4,26,-22,0.0327868852459016,20,10,30,"Positive","Grønnely ansætter ny direktør med stribevis af konkurser bag sig (99a706d9-56b2-4a71-865c-573cdb5e9939)",2022-04-01 18:00:08,2022-04-01 18:00:08
"9a472ec2-908b-4a4d-a53e-23b713500629",31,53,-22,0.22463768115942,36,13,49,"Positive","Afslag på afslag: Handicappede Kim nægtes personlig hjælper (9a472ec2-908b-4a4d-a53e-23b713500629)",2022-03-31 07:27:50,2022-03-31 07:27:50
"9c52327c-a738-456a-bb08-7998ac52c940",2,18,-16,0.0202020202020202,12,11,23,"Positive","Efter coronadyk: Langt flere biler kørte over Storebæltsbroen sidste år (9c52327c-a738-456a-bb08-7998ac52c940)",2022-03-31 16:46:54,2022-03-31 16:46:54
"9c764526-7f75-4cee-a882-784b82b551da",-3,8,-11,-0.0288461538461538,6,6,12,"Negative","Seksetagers bygning evakueret efter brand i tagpap (9c764526-7f75-4cee-a882-784b82b551da)",2022-03-24 14:56:59,2022-03-24 14:56:59
"9c83a892-bdc6-42d2-94cd-326bfb74f7f2",17,25,-8,0.139344262295082,16,7,23,"Positive","By har kæmpet for fjernvarme i otte år - nu er brev sendt afsted til Folketinget (9c83a892-bdc6-42d2-94cd-326bfb74f7f2)",2022-04-02 07:10:15,2022-04-02 07:10:15
"9d15b355-caa8-4c6b-b48b-d3f16acf0142",14,23,-9,0.0939597315436242,19,7,26,"Positive","Ekstraordinært mange nærveds-ulykker på letbanen: Det siger lokalpolitikerne om sagen (9d15b355-caa8-4c6b-b48b-d3f16acf0142)",2022-04-01 04:23:42,2022-04-01 04:23:42
"9e8a3569-15b2-4230-a967-a58fd5b8ff39",8,25,-17,0.05,18,12,30,"Positive","Christian Eriksen får grønt lys til landsholdscomeback (9e8a3569-15b2-4230-a967-a58fd5b8ff39)",2022-03-23 09:52:52,2022-03-23 09:52:52
"a056519e-71ba-43a1-aa5b-50aaaa82ae86",-4,2,-6,-0.0740740740740741,2,4,6,"Negative","Kold afslutning på marts med risiko for glatte veje (a056519e-71ba-43a1-aa5b-50aaaa82ae86)",2022-03-31 05:15:50,2022-03-31 05:15:50
"a4582265-82a6-428a-aa42-7eae176e496d",-10,8,-18,-0.087719298245614,8,13,21,"Negative","Solgte narkotika på Snapchat: 29-årig kvinde idømt fem års fængsel (a4582265-82a6-428a-aa42-7eae176e496d)",2022-03-31 13:12:37,2022-03-31 13:12:37
"a4deb95c-3dd5-4f94-b85a-e9a8154cc704",-7,7,-14,-0.074468085106383,5,8,13,"Negative","Nabo til letbanen er generet af støj: Man vågner, når de begynder at køre klokken fem (a4deb95c-3dd5-4f94-b85a-e9a8154cc704)",2022-04-01 19:38:51,2022-04-01 19:38:51
"a52b471f-0abf-4156-9a81-1bc5f284aa84",63,71,-8,0.623762376237624,32,7,39,"Positive","OB-talent: - Vigtigt at bidrage med mål (a52b471f-0abf-4156-9a81-1bc5f284aa84)",2022-04-03 17:03:52,2022-04-03 17:03:52
"a78c6f55-af7c-4f71-a453-29684077d6e0",9,43,-34,0.0416666666666667,30,21,51,"Positive","Tæt på uheld flere gange om dagen: - Hvis man følger reglerne, sker der ikke noget (a78c6f55-af7c-4f71-a453-29684077d6e0)",2022-03-30 16:53:10,2022-03-30 16:53:10
"abf33389-02b0-4288-b3ed-29eef43fa41b",-12,7,-19,-0.13953488372093,5,11,16,"Negative","Flere timers oprydning: Udbrændt lastbil lukkede motorvejsafkørsler (abf33389-02b0-4288-b3ed-29eef43fa41b)",2022-03-29 04:04:47,2022-03-29 04:04:47
"aea6c6fd-bb7f-4812-a926-0603a288e9b9",12,28,-16,0.134831460674157,17,10,27,"Positive","Fynske dyrlæger tager til den ukrainske grænse (aea6c6fd-bb7f-4812-a926-0603a288e9b9)",2022-03-24 09:15:56,2022-03-24 09:15:56
"aeb34035-2757-4406-abb5-7cc8b23d161d",18,38,-20,0.109756097560976,20,17,37,"Positive","Eriksen scorer i ydmygelse af Chelsea (aeb34035-2757-4406-abb5-7cc8b23d161d)",2022-04-02 16:11:25,2022-04-02 16:11:25
"b2f4bece-5a4c-4e4a-a543-93573e4df3f3",5,53,-48,0.0205761316872428,34,25,59,"Positive","Børnesager på Langeland: Uden medarbejdere er task force nyttesløs (b2f4bece-5a4c-4e4a-a543-93573e4df3f3)",2022-03-30 09:14:56,2022-03-30 09:14:56
"b5f48760-ad94-46ac-a4dc-0538a8715396",-6,68,-74,-0.0152671755725191,54,41,95,"Negative","Grønnely risikerer politianmeldelse: - Når jeg tænder emhætten, så starter udluftningen på badeværelset (b5f48760-ad94-46ac-a4dc-0538a8715396)",2022-04-03 12:55:01,2022-04-03 12:55:01
"bb0a0674-7961-4a63-bcc6-704032ca87a2",-9,36,-45,-0.0368852459016393,30,23,53,"Negative","Regionen vil have redegørelse efter sag om chikane af rumænske arbejdere (bb0a0674-7961-4a63-bcc6-704032ca87a2)",2022-03-30 07:00:20,2022-03-30 07:00:20
"bcb23872-4287-4d6c-bcfe-85f14066a6ea",27,67,-40,0.0957446808510638,40,21,61,"Positive","Venstre vil have russere ud af fynsk musikkonkurrence (bcb23872-4287-4d6c-bcfe-85f14066a6ea)",2022-03-22 18:21:12,2022-03-22 18:21:12
"bde5dbfe-307e-4f6c-ac0d-6f7bb2fa03ab",18,24,-6,0.146341463414634,12,4,16,"Positive","Fynsk musiker hiver tre priser i land ved prisuddeling (bde5dbfe-307e-4f6c-ac0d-6f7bb2fa03ab)",2022-04-04 07:42:51,2022-04-04 07:42:51
"bf15df3f-f381-457a-bbfe-7fd6a25dbe50",11,14,-3,0.166666666666667,9,1,10,"Positive","Se hele udsendelsen: Strynø kan blive årets ø - men hvad er det strynboerne kan? (bf15df3f-f381-457a-bbfe-7fd6a25dbe50)",2022-03-24 15:52:09,2022-03-24 15:52:09
"bfce0498-f923-4ab4-8d15-82bfbfdae0fc",-3,5,-8,-0.0508474576271186,4,5,9,"Negative","Det halvkedelige forårsvejr fortsætter (bfce0498-f923-4ab4-8d15-82bfbfdae0fc)",2022-04-01 03:54:59,2022-04-01 03:54:59
"c515b507-8f73-46a5-8a89-2978d7e48d6e",-2,11,-13,-0.0212765957446809,6,6,12,"Negative","Faktatjek: Rådmand kan ikke dokumentere egne udtalelser om russiske musikeres holdning til Ukraine (c515b507-8f73-46a5-8a89-2978d7e48d6e)",2022-03-24 05:24:43,2022-03-24 05:24:43
"c52cd225-d0b9-41c1-8094-a03a0fe65a68",-12,7,-19,-0.104347826086957,5,10,15,"Negative","Få overblikket: Fynske kommuner begår stribevis af fejl i handicapsager (c52cd225-d0b9-41c1-8094-a03a0fe65a68)",2022-03-30 04:09:42,2022-03-30 04:09:42
"cc8566a0-2bbb-4e51-8723-c49559e9dd92",15,23,-8,0.1171875,14,6,20,"Positive","Regeringen forventer over 100.000 ukrainske flygtninge (cc8566a0-2bbb-4e51-8723-c49559e9dd92)",2022-03-25 13:14:05,2022-03-25 13:14:05
"d1444dc8-0537-4913-b455-b0e737ea0c53",2,18,-16,0.00934579439252336,17,13,30,"Positive","Partier vil sænke fartgrænse for at spare olie (d1444dc8-0537-4913-b455-b0e737ea0c53)",2022-03-26 06:52:05,2022-03-26 06:52:05
"d2a1dd3e-5619-46ea-a6cb-32cfa7827fb5",-3,9,-12,-0.0340909090909091,7,7,14,"Negative","Søren Kragh trækker sig kort inden stort løb (d2a1dd3e-5619-46ea-a6cb-32cfa7827fb5)",2022-04-03 08:46:37,2022-04-03 08:46:37
"d4b83268-4c56-422f-acde-1780e50626a7",-1,10,-11,-0.0112359550561798,5,10,15,"Negative","Comeback cementerer førsteplads i grundspillet for GOG (d4b83268-4c56-422f-acde-1780e50626a7)",2022-03-23 19:50:26,2022-03-23 19:50:26
"d67818af-5ffb-4a15-83fd-9cb38b924509",17,23,-6,0.171717171717172,14,5,19,"Positive","Ingen naturnationalparker på Fyn: Borgmester er ærgerlig, men ikke overrasket (d67818af-5ffb-4a15-83fd-9cb38b924509)",2022-03-25 06:17:57,2022-03-25 06:17:57
"d6cb4c17-50c9-4c63-b5ff-5308fc380ba7",19,30,-11,0.179245283018868,16,8,24,"Positive","Lars Høgh mindes før landskamp i Parken (d6cb4c17-50c9-4c63-b5ff-5308fc380ba7)",2022-03-28 17:15:08,2022-03-28 17:15:08
"d8072fe7-9529-4af7-aa5d-884fe31ea810",8,17,-9,0.0597014925373134,12,6,18,"Positive","Rådmand vil sænke hastigheden i store dele af Odense (d8072fe7-9529-4af7-aa5d-884fe31ea810)",2022-03-27 09:00:08,2022-03-27 09:00:08
"da1b1c66-5193-4ffd-ad0e-79d8e1ae3340",-16,9,-25,-0.168421052631579,6,14,20,"Negative","Politikere vil genåbne alle børnesager på Langeland (da1b1c66-5193-4ffd-ad0e-79d8e1ae3340)",2022-03-23 12:44:41,2022-03-23 12:44:41
"da7fc0b1-aab9-442e-b402-faf38620c94c",29,37,-8,0.162921348314607,25,5,30,"Positive","Næstsidste koncert med Sigurd: Hundredvis af børn sang med på originale sange om Fyn (da7fc0b1-aab9-442e-b402-faf38620c94c)",2022-03-25 10:32:36,2022-03-25 10:32:36
"db95640a-532b-4266-927e-1ef064e26a9f",-8,13,-21,-0.0727272727272727,10,12,22,"Negative","En af Danmarks store provokatører på fynsk scene til grin og sang (db95640a-532b-4266-927e-1ef064e26a9f)",2022-04-04 12:49:29,2022-04-04 12:49:29
"dcef0284-40e6-4c8e-a86c-9ef1a89d6024",-11,16,-27,-0.0948275862068965,12,17,29,"Negative","Coronapukkel og flygtningebørn: Pædagoger står over for ny stor opgave - og det kræver en gulerod (dcef0284-40e6-4c8e-a86c-9ef1a89d6024)",2022-03-26 15:20:48,2022-03-26 15:20:48
"de03c5b2-0a88-4676-91a3-cdc794e7688a",5,13,-8,0.0757575757575758,6,5,11,"Positive","Christian Eriksen bliver anfører i Parken-comeback (de03c5b2-0a88-4676-91a3-cdc794e7688a)",2022-03-28 15:46:41,2022-03-28 15:46:41
"dea77aa2-4550-4ac2-8090-3bc8c948b6d9",15,25,-10,0.102739726027397,22,8,30,"Positive","Gratis eller betalt parkering? Beslutning i Odense midtby skal tages (dea77aa2-4550-4ac2-8090-3bc8c948b6d9)",2022-04-02 09:54:48,2022-04-02 09:54:48
"deed8c16-10b6-4e2d-bef9-49f9348f801e",-1,5,-6,-0.00952380952380952,5,3,8,"Negative","Markant flere ældre danskere er i job (deed8c16-10b6-4e2d-bef9-49f9348f801e)",2022-03-22 13:32:27,2022-03-22 13:32:27
"e18a3883-b638-40f8-9ac5-3fb839fcb7fb",22,33,-11,0.142857142857143,22,7,29,"Positive","Nærpolitistation åbnede sidste år - men nu rykker betjente langsommere ud til borgerne (e18a3883-b638-40f8-9ac5-3fb839fcb7fb)",2022-03-31 19:45:28,2022-03-31 19:45:28
"e25aa247-0c89-4a7b-9f2d-fa7a38719d7d",4,13,-9,0.0317460317460317,10,5,15,"Positive","Debat om ambulancer og akuthjælpere på Langeland (e25aa247-0c89-4a7b-9f2d-fa7a38719d7d)",2022-03-31 14:44:03,2022-03-31 14:44:03
"e2e4bbe9-5a3e-4562-8ed3-c2d2e97f2c91",-12,4,-16,-0.16,4,10,14,"Negative","Flugtbil fra påkørsel fundet i Kerteminde (e2e4bbe9-5a3e-4562-8ed3-c2d2e97f2c91)",2022-04-03 07:50:04,2022-04-03 07:50:04
"e6ec7d63-ea7e-4ac7-adf0-c1dc8e00183e",9,25,-16,0.0825688073394495,15,12,27,"Positive","Johnny har spillet billard i 30 år - 13. danmarksmestertitel er nu i hus (e6ec7d63-ea7e-4ac7-adf0-c1dc8e00183e)",2022-04-02 11:05:44,2022-04-02 11:05:44
"e91da3aa-30eb-4c41-bdb4-777bb5a5da48",-5,21,-26,-0.0367647058823529,16,15,31,"Negative","Socialrådgivere har for travlt: Dropper møder om børns trivsel (e91da3aa-30eb-4c41-bdb4-777bb5a5da48)",2022-03-29 04:49:26,2022-03-29 04:49:26
"e98870f0-6bee-4829-a0fe-6a0addde8d97",21,40,-19,0.161538461538462,23,13,36,"Positive","Op til seks ugers ventetid: Sådan kan du få hjælp til MitID uden borgerservice (e98870f0-6bee-4829-a0fe-6a0addde8d97)",2022-04-03 10:07:15,2022-04-03 10:07:15
"e99e807b-fa09-4005-aa41-bae7a8665b33",36,48,-12,0.168224299065421,31,7,38,"Positive","Hjerneblødning tog næsten livet af fynsk X Faktor-stjerne: - Jeg har genopfundet mig selv på et dybt plan (e99e807b-fa09-4005-aa41-bae7a8665b33)",2022-03-24 21:15:49,2022-03-24 21:15:49
"ebc3ea57-afee-4fa2-a869-7e0541bca33f",-4,11,-15,-0.0547945205479452,6,9,15,"Negative","Sidste solskinsdag inden frostgrader og tøsne (ebc3ea57-afee-4fa2-a869-7e0541bca33f)",2022-03-28 04:50:24,2022-03-28 04:50:24
"ebd91efc-3adc-4bcc-abb1-a8ea15ebe8d0",9,12,-3,0.0989010989010989,8,2,10,"Positive","Flere spor spærres på Storebæltsbroen (ebd91efc-3adc-4bcc-abb1-a8ea15ebe8d0)",2022-03-29 07:29:59,2022-03-29 07:29:59
"eca88ae8-7f81-4277-ad7e-9743d55336bc",-9,30,-39,-0.0489130434782609,23,20,43,"Negative","Bekymret forstander: - Hvem vil sende sin 15-årige datter på en efterskole med sådan én institution i baghaven? (eca88ae8-7f81-4277-ad7e-9743d55336bc)",2022-03-30 11:07:27,2022-03-30 11:07:27
"f12f288f-2289-4474-a7a9-c99c1779ec87",1,19,-18,0.0078740157480315,13,13,26,"Positive","Ukrainere skal have hjælp med alt fra bolig til CPR-nummer (f12f288f-2289-4474-a7a9-c99c1779ec87)",2022-03-25 09:58:01,2022-03-25 09:58:01
"f8be810c-b56a-4916-80a4-a5c787370f89",7,16,-9,0.0958904109589041,12,5,17,"Positive","I den gode sags tjeneste cyklede 130 fynboer for Ukraine (f8be810c-b56a-4916-80a4-a5c787370f89)",2022-03-28 06:28:55,2022-03-28 06:28:55
"f8e7848a-bcbb-4766-93ec-9ff1634d45ac",-9,2,-11,-0.138461538461538,2,6,8,"Negative","Mand mister livet efter frontalulykke på Vestfyn (f8e7848a-bcbb-4766-93ec-9ff1634d45ac)",2022-03-25 17:10:37,2022-03-25 17:10:37
"fb1ac2cb-3464-4489-b879-80d31c8c5550",12,27,-15,0.110091743119266,16,10,26,"Positive","Fyns Politi fortsætter samarbejde med psykiatrien (fb1ac2cb-3464-4489-b879-80d31c8c5550)",2022-03-28 09:11:43,2022-03-28 09:11:43
"fcd3b961-02e2-4cf5-af5c-06d6cde8ad76",-11,21,-32,-0.0802919708029197,17,16,33,"Negative","Borgmester afviser kritik - men udvalgsformand erkender alvorlige fejl i børnesager (fcd3b961-02e2-4cf5-af5c-06d6cde8ad76)",2022-03-23 05:01:22,2022-03-23 05:01:22
"fce050fa-a106-41c2-a6ff-b74bd95e1fee",7,30,-23,0.0457516339869281,25,16,41,"Positive","Dårligt indeklima er skyld i manglende indlæring på fynske skoler (fce050fa-a106-41c2-a6ff-b74bd95e1fee)",2022-03-29 09:48:01,2022-03-29 09:48:01
"ff8816f0-6755-4def-a617-b8a6723b25fa",7,14,-7,0.0642201834862385,10,6,16,"Positive","Finaleklare fynboer: GOG ydmyger BSH i ensidig pokalsemifinale (ff8816f0-6755-4def-a617-b8a6723b25fa)",2022-03-26 16:40:24,2022-03-26 16:40:24
"aae494ed-dbd7-47ab-b387-02fa75b01510",3,62,-59,0.0110294117647059,39,33,72,"Positive","Borgmester anerkender udfordringer - men afviser lovbrud i børnefjernelsessager (aae494ed-dbd7-47ab-b387-02fa75b01510)",2022-03-30 20:05:57,2022-03-30 20:05:57
"00b26860-e4ce-4f5c-a728-830bf8a4c056",21,33,-12,0.2625,17,9,26,"Positive","Tiårige Palma drømmer om OL - ridestævne i Odense er en start (00b26860-e4ce-4f5c-a728-830bf8a4c056)",2022-02-17 18:52:04,2022-02-17 18:52:04
"01031860-83b0-4096-8fea-4c4a12fae805",-10,8,-18,-0.117647058823529,8,13,21,"Negative","Antallet af nyindlagte på intensiv er halveret i 2022 (01031860-83b0-4096-8fea-4c4a12fae805)",2022-01-21 06:40:58,2022-01-21 06:40:58
"015fff07-c50e-47e2-95a5-221af04ab289",21,35,-14,0.147887323943662,25,8,33,"Positive","Esther er lykkelig over hjemmelavet mad på plejehjemmet: - Det er en overraskelse hver gang (015fff07-c50e-47e2-95a5-221af04ab289)",2022-03-19 10:30:05,2022-03-19 10:30:05
"01b759fd-fa62-488d-bdf5-1f9da3e50471",9,34,-25,0.12,15,18,33,"Positive","Grå søndag i vente til fynboerne (01b759fd-fa62-488d-bdf5-1f9da3e50471)",2022-01-23 07:43:05,2022-01-23 07:43:05
"01d21f59-ab07-4d87-b9f0-bba381b4e911",19,32,-13,0.165217391304348,20,10,30,"Positive","Det endelige 'ja' er givet - Sukkergrunden må blive til vandsportspark (01d21f59-ab07-4d87-b9f0-bba381b4e911)",2022-03-22 11:51:13,2022-03-22 11:51:13
"0241f6aa-1c35-4e7e-8eab-8ca9f6ecf7bd",21,27,-6,0.272727272727273,16,4,20,"Positive","Her er de nominerede til Årets Fynske Fund (0241f6aa-1c35-4e7e-8eab-8ca9f6ecf7bd)",2022-03-05 13:01:07,2022-03-05 13:01:07
"02c6b535-e623-49c9-b52a-c67125c30fa7",-35,28,-63,-0.230263157894737,20,36,56,"Negative","Vognmandsfamilie anklaget for storstilet fusk: Sådan kan man snyde systemet (02c6b535-e623-49c9-b52a-c67125c30fa7)",2022-03-16 07:53:55,2022-03-16 07:53:55
"02d7f66e-f939-4e15-a1b8-c1731c1576d3",-4,18,-22,-0.0449438202247191,13,15,28,"Negative","En hverdag uden restriktioner er fint: - Men vi er pressede i forvejen, siger pædagoger (02d7f66e-f939-4e15-a1b8-c1731c1576d3)",2022-01-26 14:45:04,2022-01-26 14:45:04
"03320a40-902a-47a8-943d-0834f0310ae9",41,144,-103,0.0990338164251208,86,58,144,"Positive","Får du også røde øjne af at se Eriksen tilbage? Ja, så er du helt normal (03320a40-902a-47a8-943d-0834f0310ae9)",2022-02-01 08:07:26,2022-02-01 08:07:26
"0363d0b6-bcc5-44c8-a81b-63d0f17bbee9",6,13,-7,0.0779220779220779,7,6,13,"Positive","Axelsen knuser inder og stryger i tysk semifinale (0363d0b6-bcc5-44c8-a81b-63d0f17bbee9)",2022-03-11 17:28:45,2022-03-11 17:28:45
"03a7e1d5-20e0-4e5b-b903-200285b15211",-12,18,-30,-0.137931034482759,14,16,30,"Negative","Se kortet: Her bor der flest fattige børn på Fyn (03a7e1d5-20e0-4e5b-b903-200285b15211)",2022-01-31 12:46:14,2022-01-31 12:46:14
"03a953fa-bd27-4272-9286-7054291e0ffc",1,11,-10,0.015625,8,6,14,"Positive","Onsdagens vejr byder på skyer og byger til fynboerne (03a953fa-bd27-4272-9286-7054291e0ffc)",2022-01-26 05:59:36,2022-01-26 05:59:36
"03badb9b-5cd6-4ee5-a6f8-14506c3fd28d",-128,222,-350,-0.118959107806691,173,265,438,"Negative","Overblik: Se, hvordan pandemien har ramt Fyn og resten af verden (03badb9b-5cd6-4ee5-a6f8-14506c3fd28d)",2022-02-22 10:43:00,2022-02-01 18:51:00
"03dfe190-cb30-419f-9981-9b35dfae5381",-11,44,-55,-0.0591397849462366,32,40,72,"Negative","Ekspert om ophør af restriktioner: - Jeg havde nok ventet (03dfe190-cb30-419f-9981-9b35dfae5381)",2022-01-26 12:15:13,2022-01-26 12:15:13
"0433a8e1-f97b-49bd-a969-9b85db218d61",-2,19,-21,-0.0208333333333333,13,13,26,"Negative","Gitte om kaotiske tilstande i Krakow: - Jeg vil have folk med hjem (0433a8e1-f97b-49bd-a969-9b85db218d61)",2022-03-03 11:54:24,2022-03-03 11:54:24
"043bb8a0-82fc-462a-8bf3-32a4e97428c3",1,20,-19,0.00833333333333333,15,17,32,"Positive","Coop ønsker aldersgrænse på 18 år for køb af al alkohol (043bb8a0-82fc-462a-8bf3-32a4e97428c3)",2022-02-23 09:34:43,2022-02-23 09:34:43
"0443046e-83ef-496a-8455-f739a18b16ba",41,55,-14,0.234285714285714,35,10,45,"Positive","Debat blusset op igen: Fynske præster nægter at vie homoseksuelle (0443046e-83ef-496a-8455-f739a18b16ba)",2022-02-07 18:25:10,2022-02-07 18:25:10
"044cd11a-9346-4e4d-8cbc-1028e3803ebe",-53,20,-73,-0.424,13,41,54,"Negative","Serieforbryder får forvaring for voldtægtsforsøg og vold (044cd11a-9346-4e4d-8cbc-1028e3803ebe)",2022-03-01 13:31:23,2022-03-01 13:31:23
"04afdea9-9fcf-448e-958b-69e1e903c107",3,21,-18,0.0294117647058824,17,10,27,"Positive","Flere krænkelser i kommunen: Byrådsmedlem vil have undersøgt tavshedskultur i Nyborg Kommune (04afdea9-9fcf-448e-958b-69e1e903c107)",2022-01-24 10:44:32,2022-01-24 10:44:32
"04c2384d-4f70-4d0d-9f3e-4ce1881894c8",7,24,-17,0.0551181102362205,18,7,25,"Positive","Se de ukrainske flygtninges nye hjem: Holmegaard er så småt klar til at blive asylcenter (04c2384d-4f70-4d0d-9f3e-4ce1881894c8)",2022-03-12 15:03:43,2022-03-12 15:03:43
"05028d7a-33e6-40a0-8c52-dbf6fdb14323",2,7,-5,0.0350877192982456,5,3,8,"Positive","Fredag bliver våd med solstrejf (05028d7a-33e6-40a0-8c52-dbf6fdb14323)",2022-02-25 05:23:36,2022-02-25 05:23:36
"051df0e6-a7c6-48b7-8bf8-b4d2eb3f571c",-9,22,-31,-0.0671641791044776,17,21,38,"Negative","Coronakurven er knækket, mener eksperter (051df0e6-a7c6-48b7-8bf8-b4d2eb3f571c)",2022-02-21 10:15:04,2022-02-21 10:15:04
"0520f026-08d2-4ab1-b59d-c2bc38d072e8",-2,6,-8,-0.0377358490566038,4,7,11,"Negative","Se billederne: Vandet gik over bredderne flere steder på Fyn (0520f026-08d2-4ab1-b59d-c2bc38d072e8)",2022-01-20 21:07:08,2022-01-20 21:07:08
"056d04b9-4c0d-451e-a4eb-f1a31849b6ad",26,46,-20,0.213114754098361,28,11,39,"Positive","Syv ukrainere kom til Assens: René flytter ud for at give plads til en familie (056d04b9-4c0d-451e-a4eb-f1a31849b6ad)",2022-03-10 20:21:24,2022-03-10 20:21:24
"05bc91f9-45bc-409a-9844-8b7ecace7208",22,45,-23,0.2,26,14,40,"Positive","Iskold vinterferie: Børn hugger isskulpturer i Middelfart (05bc91f9-45bc-409a-9844-8b7ecace7208)",2022-02-15 18:25:18,2022-02-15 18:25:18
"05ed4bea-ff00-4e92-a397-0fdda2a9ac8d",-6,9,-15,-0.133333333333333,8,11,19,"Negative","Dagens coronatal: Smitten stiger kun i to kommuner (05ed4bea-ff00-4e92-a397-0fdda2a9ac8d)",2022-02-19 15:26:29,2022-02-19 15:26:29
"05f39b93-17ea-4ada-9337-316f52c56480",54,71,-17,0.305084745762712,42,11,53,"Positive","Høgh og Falchs festival offentliggør navne: - Der er sindssygt mange følelser i det (05f39b93-17ea-4ada-9337-316f52c56480)",2022-02-04 15:00:10,2022-02-04 15:00:10
"05f64f09-ae2a-4b67-8105-76e8185f371f",13,31,-18,0.0902777777777778,21,12,33,"Positive","Ukrainere rykker ind på Holmegaard: Jonis har brugt alle sine penge på fredagsslik til flygtninge (05f64f09-ae2a-4b67-8105-76e8185f371f)",2022-03-12 16:57:50,2022-03-12 16:57:50
"0772768e-e5c2-4daf-9201-05b94713d066",-18,32,-50,-0.132352941176471,18,27,45,"Negative","Øm Gidsel forbereder sig på hårdhændet behandling (0772768e-e5c2-4daf-9201-05b94713d066)",2022-01-19 15:00:25,2022-01-19 15:00:25
"07e5af80-f701-4278-bb1c-499300774451",5,30,-25,0.0342465753424658,20,19,39,"Positive","Regeringen indkalder partier til drøftelser om høje energipriser (07e5af80-f701-4278-bb1c-499300774451)",2022-01-13 19:09:25,2022-01-13 19:09:25
"0811f769-a4f7-485f-aac2-90a2a8924a7f",-7,3,-10,-0.14,2,6,8,"Negative","Ung mand har mistet livet i brand (0811f769-a4f7-485f-aac2-90a2a8924a7f)",2022-01-30 07:06:12,2022-01-30 07:06:12
"0816d235-5a80-4ca6-b9e2-65aeb4a8e56b",-27,15,-42,-0.192857142857143,10,26,36,"Negative","Fynsk vognmandsfamilie er anklaget for storstilet fusk med førerkort (0816d235-5a80-4ca6-b9e2-65aeb4a8e56b)",2022-03-14 05:17:14,2022-03-14 05:17:14
"08484651-1853-411e-b5e2-438fadc5f561",7,16,-9,0.0752688172043011,10,6,16,"Positive","1.000 færre villaer på Fyn: Antallet af boliger til salg er det laveste i næsten 16 år (08484651-1853-411e-b5e2-438fadc5f561)",2022-02-09 08:13:17,2022-02-09 08:13:17
"085deb3d-5a4b-4558-825c-5b76182fdd9a",0,8,-8,0,5,5,10,"Negative","Kølig forårsweekend i vente (085deb3d-5a4b-4558-825c-5b76182fdd9a)",2022-03-05 06:31:50,2022-03-05 06:31:50
"08c33ded-7338-48de-bbc6-5c604242029b",5,10,-5,0.0862068965517241,8,4,12,"Positive","Heunicke: Fra søndag forkortes coronapasset (08c33ded-7338-48de-bbc6-5c604242029b)",2022-01-12 15:19:00,2022-01-12 15:19:00
"08d34d88-2c74-4ebf-bced-a2d8031394a6",-4,35,-39,-0.0233918128654971,28,26,54,"Negative","Putin-kritisk forfatter om angrebet i Ukraine: - Jeg er i choktilstand (08d34d88-2c74-4ebf-bced-a2d8031394a6)",2022-02-24 15:17:11,2022-02-24 15:17:11
"08de69f6-aafc-445e-b8b0-86ff52f29f7c",-18,7,-25,-0.26865671641791,5,20,25,"Negative","Tirsdagens coronatal: Smitten falder på Fyn efter ny rekord (08de69f6-aafc-445e-b8b0-86ff52f29f7c)",2022-02-15 14:03:25,2022-02-15 14:03:25
"0941c278-0aac-43f2-9410-80cf4878fbb8",17,34,-17,0.114864864864865,23,13,36,"Positive","Debat om afskaffelse af Storebæltsafgift: - Prisen bliver for stor (0941c278-0aac-43f2-9410-80cf4878fbb8)",2022-03-17 20:02:27,2022-03-17 20:02:27
"098761d6-59a0-41a3-a640-a0a8ff9ae1c5",31,63,-32,0.2421875,39,24,63,"Positive","Med blindestok på Kilimanjaro: Marlene vil vise, hvor meget svagtseende kan (098761d6-59a0-41a3-a640-a0a8ff9ae1c5)",2022-01-28 11:20:11,2022-01-28 11:20:11
"09c25966-1a3a-46ce-9fbf-43957b5abd23",-7,56,-63,-0.0391061452513966,36,36,72,"Negative","Kvinder bliver hårdere ramt af senfølger end mænd – det kan skyldes deres immunforsvar, siger forsker (09c25966-1a3a-46ce-9fbf-43957b5abd23)",2022-02-07 10:32:56,2022-02-07 10:32:56
"0a8582a2-c00c-4700-8277-1f386cd98f4a",51,79,-28,0.298245614035088,45,20,65,"Positive","Statsgaranti til udkantsboliger på vej - men ikke til erhvervsdrivende Janne: - De ville ikke lære mig at kende (0a8582a2-c00c-4700-8277-1f386cd98f4a)",2022-02-24 10:48:19,2022-02-24 10:48:19
"0a912f44-2e0f-44ef-ab98-406e43b57c7e",10,36,-26,0.0869565217391304,24,17,41,"Positive","Odense støtter sin krigsplagede venskabsby: Kongens Have bliver Kyivs Have (0a912f44-2e0f-44ef-ab98-406e43b57c7e)",2022-03-03 05:03:47,2022-03-03 05:03:47
"0b35bada-62ec-4d3d-98aa-396e3d671900",-7,21,-28,-0.0538461538461538,20,21,41,"Negative","Coronasmitten på OUH er fordoblet: - Det giver en ret voldsom ekstra belastning (0b35bada-62ec-4d3d-98aa-396e3d671900)",2022-02-10 21:35:58,2022-02-10 21:35:58
"0b8b7fea-1e41-4438-9ba8-45dc01251413",19,35,-16,0.191919191919192,23,15,38,"Positive","Miljøvenlige lastbiler i Odense: - Vi bidrager gerne til en renere midtby (0b8b7fea-1e41-4438-9ba8-45dc01251413)",2022-03-03 05:45:35,2022-03-03 05:45:35
"0bded66c-9f7f-4eaa-9661-6eb28e136b77",20,46,-26,0.18348623853211,24,15,39,"Positive","Hotelejer overfaldet med dårlige anmeldelser efter besked om mundbind (0bded66c-9f7f-4eaa-9661-6eb28e136b77)",2022-02-01 15:20:52,2022-02-01 15:20:52
"0be745c2-0487-4b3d-9c1d-f5ad09aa81c4",9,11,-2,0.204545454545455,6,2,8,"Positive","Sådan vil regeringen gøre danskerne sundere (0be745c2-0487-4b3d-9c1d-f5ad09aa81c4)",2022-03-15 15:46:01,2022-03-15 15:46:01
"0c102b3a-ef19-4aa8-8bc7-96f51e4296d7",-15,5,-20,-0.241935483870968,5,11,16,"Negative","Uenighed endte i knivstikkeri (0c102b3a-ef19-4aa8-8bc7-96f51e4296d7)",2022-02-02 05:19:59,2022-02-02 05:19:59
"0c283960-52b9-42bf-870e-5b317eac31f5",-1,5,-6,-0.0178571428571429,4,6,10,"Negative","Efter regnfuld weekend: Mandag byder på blæst, tøsne og en smule sol (0c283960-52b9-42bf-870e-5b317eac31f5)",2022-02-21 05:43:29,2022-02-21 05:43:29
"0ca7ecdd-5097-4c5e-84ec-4d9ae0c8b473",4,20,-16,0.0404040404040404,15,10,25,"Positive","Agentur foreslår bilfri søndage som svar på oliemangel (0ca7ecdd-5097-4c5e-84ec-4d9ae0c8b473)",2022-03-18 15:22:44,2022-03-18 15:22:44
"0ce1984c-7b47-4be6-bfec-4ba7f192a648",27,42,-15,0.18,27,11,38,"Positive","Enhedslisten i Odense: Viceborgmesteren skal arbejde mere for pengene (0ce1984c-7b47-4be6-bfec-4ba7f192a648)",2022-02-19 16:40:02,2022-02-19 16:40:02
"0e186348-498b-4fd8-9ce4-619b1a6aabb0",17,45,-28,0.100591715976331,31,19,50,"Positive","Forslag om gratis bro skal i Folketinget - får blandet modtagelse (0e186348-498b-4fd8-9ce4-619b1a6aabb0)",2022-02-21 21:02:25,2022-02-21 21:02:25
"0e1f0468-0efc-4504-aa31-6a7fa50e02cc",25,29,-4,0.367647058823529,17,3,20,"Positive","Efter flere coronatilfælde: Fynsk gymnasie sender elever hjem til virtuel undervisning (0e1f0468-0efc-4504-aa31-6a7fa50e02cc)",2022-02-08 09:43:48,2022-02-08 09:43:48
"0eb1a28c-8b43-4f0f-8852-39206a2804f4",50,57,-7,0.36231884057971,33,5,38,"Positive","Særlov glæder ukrainske Daria: - Det er vigtigt for os at arbejde (0eb1a28c-8b43-4f0f-8852-39206a2804f4)",2022-03-16 20:45:12,2022-03-16 20:45:12
"0ed001b4-c136-443a-9ba6-9bf6213b3f46",16,36,-20,0.132231404958678,25,12,37,"Positive","Arsen i drikkevandet kan give misdannelser hos nyfødte (0ed001b4-c136-443a-9ba6-9bf6213b3f46)",2022-03-16 06:21:03,2022-03-16 06:21:03
"0f3f7569-8f04-4ed6-a96d-b29666521475",39,58,-19,0.163179916317992,39,14,53,"Positive","Fynske kommuner gør klar til flygtninge: - Det er mennesker i en ulykkelig situation (0f3f7569-8f04-4ed6-a96d-b29666521475)",2022-03-01 07:33:31,2022-03-01 07:33:31
"0f9cef72-f02a-4777-aba5-76439c5c7e70",-4,6,-10,-0.0740740740740741,3,6,9,"Negative","Søger vidne efter spirituskørsel: Politiet efterlyser føreren af en blå Kia (0f9cef72-f02a-4777-aba5-76439c5c7e70)",2022-01-16 11:12:36,2022-01-16 11:12:36
"0fc27e45-2379-4209-867b-a61b36a82800",-1,3,-4,-0.0217391304347826,3,4,7,"Negative","Onsdagens coronatal: Tæt på 15.000 fynske smittetilfælde på en uge (0fc27e45-2379-4209-867b-a61b36a82800)",2022-01-19 13:53:12,2022-01-19 13:53:12
"10e76361-963d-4238-a657-ad6a2f0d06db",40,58,-18,0.43956043956044,40,9,49,"Positive","Svær begyndelse: Borgerservice hjælper med Mit-id (10e76361-963d-4238-a657-ad6a2f0d06db)",2022-01-27 17:35:46,2022-01-27 17:35:46
"1104459f-3e8b-4281-ae8e-efad9a51ec4d",-22,28,-50,-0.138364779874214,22,30,52,"Negative","Akut mangel på tandlæger: - Det presser os helt ud i det urimelige (1104459f-3e8b-4281-ae8e-efad9a51ec4d)",2022-01-14 05:13:24,2022-01-14 05:13:24
"112023dc-68b5-41c1-9b8d-c0b9d5fa2d3d",42,67,-25,0.238636363636364,44,22,66,"Positive","EU klar med plan for at blive uafhængig af russisk gas (112023dc-68b5-41c1-9b8d-c0b9d5fa2d3d)",2022-03-08 10:54:04,2022-03-08 10:54:04
"11669b35-0bef-4d96-9287-69764d3663b6",4,18,-14,0.0404040404040404,13,11,24,"Positive","Efter flyvende metalstykker: Kommune går ind i sag om farlig fabrik i Højrup (11669b35-0bef-4d96-9287-69764d3663b6)",2022-02-10 20:28:41,2022-02-10 20:28:41
"11bd084d-6ee8-43e7-8696-2e1455aeaceb",-19,50,-69,-0.0979381443298969,42,41,83,"Negative","Flere eksperter sagde nej til skolelukninger - men det skete igen og igen (11bd084d-6ee8-43e7-8696-2e1455aeaceb)",2022-02-01 20:51:11,2022-02-01 20:51:11
"11c2cbc5-54b7-45a9-9d9c-327f45fac68c",3,39,-36,0.01875,25,28,53,"Positive","Naboer i opråb efter endnu et påbud til farlig fabrik: Næste skridt kan blive politianmeldelse (11c2cbc5-54b7-45a9-9d9c-327f45fac68c)",2022-02-11 21:15:05,2022-02-11 21:15:05
"11c627c9-1d87-4be7-8ba6-5be7788a4a8a",25,36,-11,0.2,24,6,30,"Positive","Forbud imod alkohol til unge under 18 år: - Vi fester jo relativt meget (11c627c9-1d87-4be7-8ba6-5be7788a4a8a)",2022-03-15 20:15:41,2022-03-15 20:15:41
"1200d994-914e-4173-a13d-c157eaa6bae0",-23,11,-34,-0.185483870967742,7,19,26,"Negative","Væbnet røveri mod Rema 1000 - gerningsmand med speciel gangart efterlyst (1200d994-914e-4173-a13d-c157eaa6bae0)",2022-02-03 12:49:00,2022-02-02 21:12:03
"12eb0837-a5ac-4588-8bcb-a0374450fa59",1,11,-10,0.0135135135135135,10,7,17,"Positive","Norsk politi: Derfor blev nedlagt gartneri ransaget (12eb0837-a5ac-4588-8bcb-a0374450fa59)",2022-01-27 15:23:58,2022-01-27 15:23:58
"136180e7-93ad-43f1-8dcb-ab2e769dcdef",-4,40,-44,-0.028169014084507,33,36,69,"Negative","SSI: Vi bevæger os mod ""influenzalignende"" tilstande (136180e7-93ad-43f1-8dcb-ab2e769dcdef)",2022-01-13 08:38:41,2022-01-13 08:38:41
"143c57c9-2b39-4082-ab36-910270cda837",28,48,-20,0.148936170212766,38,15,53,"Positive","Forstærket kamp mod giftudledninger: Tre gartnerier har nu fået alle tilladelser på plads (143c57c9-2b39-4082-ab36-910270cda837)",2022-03-21 15:30:06,2022-03-21 15:30:06
"14c47b9e-45d7-4f06-91ae-1084bcfdea7e",4,31,-27,0.0266666666666667,25,16,41,"Positive","Ingen kompensation for aflyste russiske arrangementer (14c47b9e-45d7-4f06-91ae-1084bcfdea7e)",2022-02-28 18:30:02,2022-02-28 18:30:02
"150ccd47-19a0-45a0-a192-74827499640d",1,16,-15,0.00819672131147541,12,10,22,"Positive","Storm besværliggør eftersøgning af 81-årig (150ccd47-19a0-45a0-a192-74827499640d)",2022-02-18 08:25:00,2022-02-17 12:48:51
"157d02d9-83fd-4bc4-8817-e5dff9323ea8",-9,18,-27,-0.102272727272727,15,21,36,"Negative","Tirsdagens coronatal: Smitten stiger i alle kommuner (157d02d9-83fd-4bc4-8817-e5dff9323ea8)",2022-01-18 15:06:10,2022-01-18 15:06:10
"157e4199-01a1-4754-8af6-c74e9b2dc32a",8,31,-23,0.0714285714285714,21,13,34,"Positive","Efter Maliks rasen: Borgmestre efterspørger plan for klimatilpasning (157e4199-01a1-4754-8af6-c74e9b2dc32a)",2022-01-31 18:58:43,2022-01-31 18:58:43
"1599c08b-c3fc-44f9-bd4c-6f4d33fa1612",1,7,-6,0.0161290322580645,6,3,9,"Positive","Fynboerne kan torsdag se frem til blæst og byger (1599c08b-c3fc-44f9-bd4c-6f4d33fa1612)",2022-01-27 05:22:06,2022-01-27 05:22:06
"15a76070-873e-4479-ae3d-515d1e0f2940",41,53,-12,0.292857142857143,33,7,40,"Positive","Danmarks hurtigst voksende sportsgren har hjemsted på Fyn (15a76070-873e-4479-ae3d-515d1e0f2940)",2022-02-15 11:03:03,2022-02-15 11:03:03
"15bd4029-3f03-4dc5-a11c-eedfa71f5d01",38,55,-17,0.322033898305085,33,10,43,"Positive","Finjusteret krop skal gøre Gidsel til en del af berlinmuren (15bd4029-3f03-4dc5-a11c-eedfa71f5d01)",2022-01-10 06:29:12,2022-01-10 06:29:12
"160da466-4572-41de-885e-152745f851de",7,14,-7,0.194444444444444,9,4,13,"Positive","Vejret: Frisk dag i møde (160da466-4572-41de-885e-152745f851de)",2022-02-07 06:20:27,2022-02-07 06:20:27
"163ea8da-273f-4149-b9af-e082eeaa6e4b",24,53,-29,0.123076923076923,38,22,60,"Positive","Nyborg Slot: Er museumslov eller anlægslov hurtigst? (163ea8da-273f-4149-b9af-e082eeaa6e4b)",2022-02-09 15:51:29,2022-02-09 15:51:29
"165bff46-7de5-4fad-bc8e-ab6354d03710",21,31,-10,0.181034482758621,19,6,25,"Positive","Tæt på dronningen: Hun stiller krav til sine bordherrer (165bff46-7de5-4fad-bc8e-ab6354d03710)",2022-01-14 06:17:35,2022-01-14 06:17:35
"16dcaf93-8790-4683-b54b-4eaaab828409",13,52,-39,0.0948905109489051,37,33,70,"Positive","Dyrenes Alliance: Zoologisk have er uetisk (16dcaf93-8790-4683-b54b-4eaaab828409)",2022-01-26 17:55:13,2022-01-26 17:55:13
"16f7997b-7d4e-49ee-a630-53896f929fcd",14,28,-14,0.138613861386139,19,9,28,"Positive","Christian Eriksen træner i Ajax (16f7997b-7d4e-49ee-a630-53896f929fcd)",2022-01-25 14:53:00,2022-01-25 14:43:16
"1733250a-c9de-4b1b-825f-ca2fbfc4590f",-6,15,-21,-0.058252427184466,12,12,24,"Negative","19-årig dræbt: Politiet søger fortsat vidner for at lægge ""puslespillet"" (1733250a-c9de-4b1b-825f-ca2fbfc4590f)",2022-02-28 16:08:30,2022-02-28 16:08:30
"17ef419c-3fc6-4fd5-8c6d-c6741185bf14",-28,40,-68,-0.148148148148148,29,40,69,"Negative","Krimiredaktør om bandeopgør: - En klar eksalering (17ef419c-3fc6-4fd5-8c6d-c6741185bf14)",2022-01-15 17:24:21,2022-01-15 17:24:21
"17aaf06b-c57d-4996-a676-33b6ea49c7fd",-9,16,-25,-0.0782608695652174,12,13,25,"Negative","Fyns Politi efterlyser vidner: 19-årig skuddræbt på parkeringsplads (17aaf06b-c57d-4996-a676-33b6ea49c7fd)",2022-02-27 08:41:00,2022-02-27 08:41:00
"18490b28-afc7-427f-8558-c7e4bd65e828",13,27,-14,0.135416666666667,19,12,31,"Positive","Regler lempes så chauffører kan køre længere mellem hvil (18490b28-afc7-427f-8558-c7e4bd65e828)",2022-03-05 13:17:04,2022-03-05 13:17:04
"18e5ee99-7cbd-471c-8a67-918480056144",18,34,-16,0.0967741935483871,28,10,38,"Positive","Overblik: Det går pengene fra Storebæltsbroen til (18e5ee99-7cbd-471c-8a67-918480056144)",2022-03-17 09:28:07,2022-03-17 09:28:07
"18f7b0db-e569-4c5a-a742-a78be704e3cf",15,38,-23,0.121951219512195,24,16,40,"Positive","Metalstykker fløj gennem byen under stormen: Naboer kræver ikonisk fabrik sikret eller revet ned (18f7b0db-e569-4c5a-a742-a78be704e3cf)",2022-02-04 09:20:46,2022-02-04 09:20:46
"19108c9f-a64c-43d3-9a52-9336772c6c71",4,5,-1,0.0701754385964912,5,1,6,"Positive","Se debatten: Skal Storebæltsbroen gøres gratis? (19108c9f-a64c-43d3-9a52-9336772c6c71)",2022-03-17 15:51:53,2022-03-17 15:51:53
"196f8b5a-85f2-4094-8b45-7d3888f4617e",19,29,-10,0.132867132867133,20,7,27,"Positive","Tyske turister strømmer til Fyn: - De kan sikre helårsstillinger i turisterhvervet (196f8b5a-85f2-4094-8b45-7d3888f4617e)",2022-02-14 17:12:06,2022-02-14 17:12:06
"1995957e-2a10-4270-bd31-4b1e776ff03c",1,16,-15,0.01,13,10,23,"Positive","OUH-entreprenør betaler millioner i forlig (1995957e-2a10-4270-bd31-4b1e776ff03c)",2022-03-14 15:37:54,2022-03-14 15:37:54
"19a01f86-16d6-4cfa-a476-e8013c67b265",-22,23,-45,-0.159420289855072,18,29,47,"Negative","Fynsk formand forlader sin post i protest over Putins angreb (19a01f86-16d6-4cfa-a476-e8013c67b265)",2022-02-24 08:35:35,2022-02-24 08:35:35
"19c0e176-4520-468d-9ece-2c8f98815650",7,23,-16,0.0578512396694215,14,12,26,"Positive","Fiskere skal nu sejle med overvågningskamera - og det er de utilfredse med: - Vi bliver bombarderet fra alle sider (19c0e176-4520-468d-9ece-2c8f98815650)",2022-03-16 18:54:12,2022-03-16 18:54:12
"1a02a375-a433-4723-8739-9d24c813bcc3",16,25,-9,0.158415841584158,15,7,22,"Positive","Fra fantasiprojekt til fast transport: 22 elbiler ruller ind i Assens (1a02a375-a433-4723-8739-9d24c813bcc3)",2022-02-01 17:01:08,2022-02-01 17:01:08
"1a40874f-daca-4fd2-851b-abca80bf249c",27,40,-13,0.228813559322034,31,9,40,"Positive","Torsdag kan ende med blodregn i Danmark (1a40874f-daca-4fd2-851b-abca80bf249c)",2022-03-17 05:56:59,2022-03-17 05:56:59
"1ae04eff-24b4-48a3-bec9-26c0dca41f7e",25,52,-27,0.148809523809524,37,21,58,"Positive","Serviceassistenter nedlægger igen arbejdet på OUH (1ae04eff-24b4-48a3-bec9-26c0dca41f7e)",2022-02-02 14:31:27,2022-02-02 14:31:27
"1af1d368-2fcb-44bb-a89f-cc023910ee24",28,60,-32,0.145833333333333,41,25,66,"Positive","Gaspriser stiger markant: Ivan nåede at få fjernvarme i sit hus - og han er lettet (1af1d368-2fcb-44bb-a89f-cc023910ee24)",2022-03-08 14:47:31,2022-03-08 14:47:31
"1b14c0d0-751b-47e0-b4f5-1b737972edb8",-7,1,-8,-0.155555555555556,1,5,6,"Negative","Bil er endt på hovedet efter uheld på befærdet vej (1b14c0d0-751b-47e0-b4f5-1b737972edb8)",2022-02-09 06:30:20,2022-02-09 06:30:20
"1b59cd35-a5df-4d0a-9fca-cb05a51c38ba",12,57,-45,0.0659340659340659,37,25,62,"Positive","96-årige Mette har klart budskab - vil selv bestemme over sin død (1b59cd35-a5df-4d0a-9fca-cb05a51c38ba)",2022-02-03 14:13:13,2022-02-03 14:13:13
"1b82fced-39db-45ab-aa1c-4a6e0de603ad",11,25,-14,0.0887096774193548,20,11,31,"Positive","Varsel om forhøjet vandstand: Topper ved 110-130 centimeter over normalen (1b82fced-39db-45ab-aa1c-4a6e0de603ad)",2022-01-20 07:55:07,2022-01-20 07:55:07
"1b8c1126-ec3e-4660-9547-744c008c6f7e",2,16,-14,0.0208333333333333,11,9,20,"Positive","Stormflod: Beboere kan søge tilflugt på skole (1b8c1126-ec3e-4660-9547-744c008c6f7e)",2022-01-30 06:30:07,2022-01-30 06:30:07
"1ba41372-464c-4593-b2dd-15580c8295d5",21,32,-11,0.179487179487179,22,6,28,"Positive","Se opvarmning til støttekoncert på Flakhaven (1ba41372-464c-4593-b2dd-15580c8295d5)",2022-03-12 17:45:07,2022-03-12 17:45:07
"1bbabdb9-d322-42f1-b685-61c2e689a0f5",3,22,-19,0.0256410256410256,15,16,31,"Positive","Det er snart slut med restriktioner, men smittetallet er højere end nogensinde før (1bbabdb9-d322-42f1-b685-61c2e689a0f5)",2022-01-27 13:46:43,2022-01-27 13:46:43
"1bf20b39-2477-4a0c-aea4-3ef4ed283d6f",0,16,-16,0,12,12,24,"Negative","Regeringen vil have alle restriktioner væk med månedens udløb (1bf20b39-2477-4a0c-aea4-3ef4ed283d6f)",2022-01-26 08:10:31,2022-01-26 08:10:31
"1c56429d-34ad-4b3f-a860-a4dee0f33a71",8,31,-23,0.106666666666667,17,11,28,"Positive","Ukrainsk-russisk ægtepar ser forfærdet til: Det er Putins krig - ikke Ruslands (1c56429d-34ad-4b3f-a860-a4dee0f33a71)",2022-02-27 15:05:07,2022-02-27 15:05:07
"1c8b66dd-dda2-4159-9692-aa5557b5bd96",-7,21,-28,-0.0507246376811594,19,21,40,"Negative","På størrelse med 100 fodboldbaner: Arla bygger gigantisk solcellepark på Fyn (1c8b66dd-dda2-4159-9692-aa5557b5bd96)",2022-01-31 20:47:23,2022-01-31 20:47:23
"1c9c51e3-992a-4488-be6b-5074dea93dd2",5,40,-35,0.0381679389312977,23,24,47,"Positive","Reinhardt tilbage fra spøjs skade, da Odense vandt igen (1c9c51e3-992a-4488-be6b-5074dea93dd2)",2022-02-17 08:40:15,2022-02-17 08:40:15
"1cc2cdc5-7ad8-4757-ba3b-61c61f88a860",5,13,-8,0.104166666666667,8,7,15,"Positive","Det bliver en skyet men tør tirsdag (1cc2cdc5-7ad8-4757-ba3b-61c61f88a860)",2022-01-25 05:42:49,2022-01-25 05:42:49
"1cf9598f-8777-433e-9e27-efbb721c49cd",-15,31,-46,-0.0622406639004149,23,31,54,"Negative","Tidligere ejer afviser ansvar for højspændingskabel tæt på beboelse (1cf9598f-8777-433e-9e27-efbb721c49cd)",2022-02-24 16:41:53,2022-02-24 16:41:53
"1d42fc8c-b3aa-4062-ab6f-22cce7b02bbd",15,41,-26,0.104166666666667,26,17,43,"Positive","Eksperterne har talt: - Vi er ovre det værste (1d42fc8c-b3aa-4062-ab6f-22cce7b02bbd)",2022-02-03 08:42:35,2022-02-03 08:42:35
"1d6ec3d6-4646-44cb-83db-b724a134e376",23,84,-61,0.0916334661354582,52,39,91,"Positive","Da Hannes kræft var væk, kom tankemylderet: Ny klinik udreder kræftpatienters senfølger (1d6ec3d6-4646-44cb-83db-b724a134e376)",2022-03-06 11:56:59,2022-03-06 11:56:59
"1d738419-9d49-46d2-b9a1-7f9a4bcfe598",39,74,-35,0.229411764705882,47,20,67,"Positive","Karakterproblemer i Nyborg: - Jeg troede faktisk, at vi klarede os fint nok (1d738419-9d49-46d2-b9a1-7f9a4bcfe598)",2022-01-19 06:46:12,2022-01-19 06:46:12
"1da246dd-c633-4d75-a320-cdba7608c81d",48,77,-29,0.212389380530973,45,22,67,"Positive","Almira flygtede fra Bosnien til Langeland: - Jeg vil gerne give ukrainerene samme varme velkomst, jeg selv modtog (1da246dd-c633-4d75-a320-cdba7608c81d)",2022-03-20 11:57:58,2022-03-20 11:57:58
"1e14cee4-9dc9-4aa3-82d3-9637c491ebe7",0,55,-55,0,30,31,61,"Negative","Gidsel efter dansk nederlag: - Jeg er sgu røvskuffet (1e14cee4-9dc9-4aa3-82d3-9637c491ebe7)",2022-01-28 19:59:18,2022-01-28 19:59:18
"1ed7015b-247c-41c0-ad59-da29099e9a7c",-13,5,-18,-0.131313131313131,4,9,13,"Negative","23-årig mister livet i arbejdsulykke på fynsk værft (1ed7015b-247c-41c0-ad59-da29099e9a7c)",2022-02-16 15:29:37,2022-02-16 15:29:37
"1f742a73-2406-4454-abe1-4331b7e9b9dd",76,112,-36,0.417582417582418,67,23,90,"Positive","Svendebrev eller studenterhue? Her er ekspertens råd til at vælge ungdomsuddannelse (1f742a73-2406-4454-abe1-4331b7e9b9dd)",2022-02-27 10:31:03,2022-02-27 10:31:03
"1feb0e84-d8a4-4a9e-b07f-106efa0e4d2e",-24,18,-42,-0.24,15,26,41,"Negative","Pandemien kan stadig mærkes på OUH: - Vi har et meget presset hus (1feb0e84-d8a4-4a9e-b07f-106efa0e4d2e)",2022-02-23 21:02:10,2022-02-23 21:02:10
"1aac6c57-f54c-49e3-97f8-0e9b62de4ba0",-20,12,-32,-0.227272727272727,10,22,32,"Negative","Kajakroer rydder op ved kanalen: Det har været sådan her i adskillige år (1aac6c57-f54c-49e3-97f8-0e9b62de4ba0)",2022-02-19 13:56:13,2022-02-19 13:56:13
"20461aee-9c15-4f87-baa0-fc290027819b",5,17,-12,0.0617283950617284,12,8,20,"Positive","Ukrainske flygtninge viser udbombede bygninger: Engang var det mit hjem (20461aee-9c15-4f87-baa0-fc290027819b)",2022-03-04 13:57:09,2022-03-04 13:57:09
"204bd945-f6eb-4b81-88c0-729bf74b3def",13,16,-3,0.228070175438596,11,2,13,"Positive","Forårsagtigt vejr luner fynboerne i weekenden (204bd945-f6eb-4b81-88c0-729bf74b3def)",2022-02-26 06:40:56,2022-02-26 06:40:56
"205a1083-9c35-48d5-b0c7-4b0a7749fff2",3,20,-17,0.04,16,10,26,"Positive","Visitationszone forlænges for fjerde gang (205a1083-9c35-48d5-b0c7-4b0a7749fff2)",2022-01-18 14:22:54,2022-01-18 14:22:54
"20bdd6d1-3e8b-4d27-bc97-cca194ae12c9",9,14,-5,0.116883116883117,12,4,16,"Positive","Fund af pesticid i drikkevand på Sydfyn (20bdd6d1-3e8b-4d27-bc97-cca194ae12c9)",2022-02-17 11:13:14,2022-02-17 11:13:14
"20d53587-44f7-40db-a19e-ce7b2fd00a25",8,47,-39,0.0563380281690141,30,23,53,"Positive","OB tabte føringen i den sidste overtid (20d53587-44f7-40db-a19e-ce7b2fd00a25)",2022-02-27 19:13:46,2022-02-27 19:13:46
"21353bea-46e4-4b27-83a1-ebd6a6ef43c9",-9,9,-18,-0.132352941176471,6,15,21,"Negative","Masser af sol og lunt vejr på vej (21353bea-46e4-4b27-83a1-ebd6a6ef43c9)",2022-03-18 06:06:08,2022-03-18 06:06:08
"213c4199-16bb-494d-8a02-ad3138c22fa4",45,67,-22,0.308219178082192,38,14,52,"Positive","Partifæller har truet med at forlade partiet: Fynske DF'ere håber på forsoning (213c4199-16bb-494d-8a02-ad3138c22fa4)",2022-01-23 17:08:45,2022-01-23 17:08:45
"2144abb9-95c8-41d1-b162-0729f75dd992",10,27,-17,0.0952380952380952,21,12,33,"Positive","Frank brugte halvanden måned på at sikre sig Eriksen (2144abb9-95c8-41d1-b162-0729f75dd992)",2022-02-02 18:41:03,2022-02-02 18:41:03
"2184d62c-6206-4108-9629-34a73a1a9cfc",23,66,-43,0.119170984455959,38,29,67,"Positive","Odense-spillere i isolation før OL: - Jeg panikker lidt hver dag (2184d62c-6206-4108-9629-34a73a1a9cfc)",2022-01-22 19:13:13,2022-01-22 19:13:13
"21cf03ec-2612-458f-affe-753933ea97ab",19,26,-7,0.191919191919192,18,5,23,"Positive","Kashmir og Anne Linnet kommer til Fyn: Heartland fuldender musikprogrammet (21cf03ec-2612-458f-affe-753933ea97ab)",2022-03-15 07:00:12,2022-03-15 07:00:12
"21e11d3a-63d3-48c8-a113-681463587d08",1,15,-14,0.0181818181818182,10,8,18,"Positive","Madlavning gik galt - brand i lejlighed i Odense (21e11d3a-63d3-48c8-a113-681463587d08)",2022-02-08 18:19:44,2022-02-08 18:19:44
"221dafd7-7d8b-46f2-a8b3-1a9fdb15b74b",-19,5,-24,-0.246753246753247,5,13,18,"Negative","Bilist dræbt i ulykke på motorvejen (221dafd7-7d8b-46f2-a8b3-1a9fdb15b74b)",2022-01-13 05:20:00,2022-01-12 19:20:00
"2289e92e-f2f1-4d89-94ba-3fb3f54fc3dd",20,56,-36,0.117647058823529,41,27,68,"Positive","Mette Frederiksen: Coronarestriktioner er snart fortid (2289e92e-f2f1-4d89-94ba-3fb3f54fc3dd)",2022-01-26 17:36:27,2022-01-26 17:36:27
"22c50d74-0d90-4a34-92ce-8cd3fdbc0a0d",13,23,-10,0.1625,12,6,18,"Positive","Første navne på plads: Rasmus Seebach til HCA Festivals (22c50d74-0d90-4a34-92ce-8cd3fdbc0a0d)",2022-02-02 09:27:47,2022-02-02 09:27:47
"232e1f68-2288-448b-bf38-254122dfda48",18,28,-10,0.142857142857143,20,7,27,"Positive","Solgte stoffer på Snapchat: Fyns Politi finder flere kilo narkotika i stor aktion på Ærø (232e1f68-2288-448b-bf38-254122dfda48)",2022-01-26 10:52:34,2022-01-26 10:52:34
"23705ef7-2f0a-4dd8-9098-f0ec98eb2bae",46,68,-22,0.446601941747573,36,15,51,"Positive","- Det er helt sindssygt, siger Axelsen (23705ef7-2f0a-4dd8-9098-f0ec98eb2bae)",2022-03-20 06:19:30,2022-03-20 06:19:30
"23fce1ba-470a-4c15-9f44-42e35102aa40",-3,26,-29,-0.0252100840336134,18,16,34,"Negative","Blodtransfusion til bevidstløst Jehovas vidne var lovlig (23fce1ba-470a-4c15-9f44-42e35102aa40)",2022-02-01 13:08:05,2022-02-01 13:08:05
"2443cb06-5363-4c73-9b16-3a76e2939505",29,33,-4,0.25,20,3,23,"Positive","Fynske ishockeykvinder til OL: - Det har ligget i kortene, siden jeg var barn (2443cb06-5363-4c73-9b16-3a76e2939505)",2022-01-10 20:51:13,2022-01-10 20:51:13
"24d8ff65-77b0-4944-a6f6-4ab61aaed5cd",-5,11,-16,-0.0531914893617021,9,9,18,"Negative","Ny storm på vej: Nora rammer os fredag (24d8ff65-77b0-4944-a6f6-4ab61aaed5cd)",2022-02-17 07:05:50,2022-02-17 07:05:50
"254f242a-c115-4f4e-be87-e0b597431c9e",52,81,-29,0.27807486631016,49,18,67,"Positive","Få svar fra bussen på vej til Polen: - Vi kan hjælpe flere i en bus end i en bil (254f242a-c115-4f4e-be87-e0b597431c9e)",2022-03-01 15:00:09,2022-03-01 15:00:09
"25f297a8-d835-4664-8aa5-40dcf60f3065",0,17,-17,0,13,14,27,"Negative","Se tal for dit sogn: Over 24.000 smittede på Fyn den seneste uge (25f297a8-d835-4664-8aa5-40dcf60f3065)",2022-01-26 13:50:25,2022-01-26 13:50:25
"2604fc26-e2a8-4ee1-b27f-ad4ca2506453",-21,19,-40,-0.157894736842105,11,24,35,"Negative","Regnefejl koster kommune 20 millioner: - Vi ærgrer os i den grad (2604fc26-e2a8-4ee1-b27f-ad4ca2506453)",2022-02-12 17:43:02,2022-02-12 17:43:02
"269d0177-c931-4651-9fdc-83a4bb8e4379",15,23,-8,0.185185185185185,13,6,19,"Positive","Fynboerne får smuk og solrig mandag (269d0177-c931-4651-9fdc-83a4bb8e4379)",2022-03-07 06:33:11,2022-03-07 06:33:11
"26b03498-6a9c-4117-b91a-27296ce65b0e",4,31,-27,0.0470588235294118,24,18,42,"Positive","Hver anden bliver ikke screenet for livmoderhalskræft: Hjemmetest kan være løsningen (26b03498-6a9c-4117-b91a-27296ce65b0e)",2022-01-19 20:49:10,2022-01-19 20:49:10
"26dee434-a8f6-4695-b66d-ea5e7674dd71",37,57,-20,0.196808510638298,37,15,52,"Positive","Vildere natur: Nyborg skal have en folkefrugtpark (26dee434-a8f6-4695-b66d-ea5e7674dd71)",2022-02-20 18:22:31,2022-02-20 18:22:31
"26eb9542-3558-4e96-b174-782c0b3b79de",8,24,-16,0.073394495412844,15,11,26,"Positive","Storebæltsbroen lukkes på stor rejsedag (26eb9542-3558-4e96-b174-782c0b3b79de)",2022-03-09 05:08:42,2022-03-09 05:08:42
"272e4d96-2ce9-407f-a4b6-5436754f29e4",23,42,-19,0.191666666666667,19,11,30,"Positive","Der blev gyset og guset på Helnæs: Derfor bør man sætte sig i en iskold balje vand (272e4d96-2ce9-407f-a4b6-5436754f29e4)",2022-01-15 18:46:37,2022-01-15 18:46:37
"279a1365-568e-4bfd-a532-4aaa9daf498e",20,44,-24,0.18348623853211,27,12,39,"Positive","Odense vil nedbringe narkorelateret død: - 12 sekunder efter jeg havde givet modgiften, stod han op (279a1365-568e-4bfd-a532-4aaa9daf498e)",2022-01-26 20:35:22,2022-01-26 20:35:22
"27d66ca9-8518-4558-8996-5dd2eca05cf0",-26,31,-57,-0.147727272727273,23,35,58,"Negative","17-årige Eren modtog hadbesked efter tv-interview: - Der er alt for mange muslimer i Danmark (27d66ca9-8518-4558-8996-5dd2eca05cf0)",2022-03-20 16:27:27,2022-03-20 16:27:27
"27d9b0aa-982c-4b24-9c68-897e03e50a55",48,62,-14,0.333333333333333,46,11,57,"Positive","Frivillige skaber ny søredningsstation i Faaborg (27d9b0aa-982c-4b24-9c68-897e03e50a55)",2022-02-23 05:44:28,2022-02-23 05:44:28
"283f5499-6b47-49a5-8d4a-5b2c7fce164b",13,19,-6,0.173333333333333,13,6,19,"Positive","Myndigheder er i gang med at skrue ned for testblusset (283f5499-6b47-49a5-8d4a-5b2c7fce164b)",2022-02-09 12:14:03,2022-02-09 12:14:03
"28658ec7-95cf-4eac-b17b-ce2d8d808333",34,56,-22,0.209876543209877,33,14,47,"Positive","Coronaplagede dagtilbud kan begrænse åbningstid i særlige tilfælde (28658ec7-95cf-4eac-b17b-ce2d8d808333)",2022-01-10 05:11:26,2022-01-10 05:11:26
"28664f8a-6d23-425c-bb97-223fcefdc3cd",-11,33,-44,-0.0654761904761905,25,26,51,"Negative","Kommission uddeler kritik efter nærulykke på Storebælt: - Det kunne være gået rigtig galt (28664f8a-6d23-425c-bb97-223fcefdc3cd)",2022-01-13 09:47:05,2022-01-13 09:47:05
"28926389-f101-4e01-895b-92e55e749064",39,60,-21,0.204188481675393,41,16,57,"Positive","Interessen er eksploderet: Fjernvarme Fyn tredobler antallet af nye tilkoblinger (28926389-f101-4e01-895b-92e55e749064)",2022-03-15 17:36:24,2022-03-15 17:36:24
"292a7f13-4722-4e04-a1eb-15bc5938b7fa",33,53,-20,0.150684931506849,37,13,50,"Positive","DBU vil lægge nyt træningscenter til en halv milliard i Odense (292a7f13-4722-4e04-a1eb-15bc5938b7fa)",2022-03-07 16:04:50,2022-03-07 16:04:50
"29646909-f9c0-4fc6-a7f6-f9eec842b3a8",33,58,-25,0.244444444444444,33,18,51,"Positive","Odense taber pokaltitel til et overlegent Team Esbjerg (29646909-f9c0-4fc6-a7f6-f9eec842b3a8)",2022-02-27 16:08:54,2022-02-27 16:08:54
"298cbe58-0a6c-4814-a1a7-25fde9255fec",-7,19,-26,-0.0546875,12,15,27,"Negative","Fynske fiskere ærgerlige over udsigt til nye regler for ålefiskeri (298cbe58-0a6c-4814-a1a7-25fde9255fec)",2022-01-12 11:04:11,2022-01-12 11:04:11
"29d958a5-09f0-434b-b34c-c753642e7bb5",5,12,-7,0.0675675675675676,9,5,14,"Positive","Medie: Brentford tilbyder Christian Eriksen kontrakt (29d958a5-09f0-434b-b34c-c753642e7bb5)",2022-01-17 12:04:57,2022-01-17 12:04:57
"2a2111ba-ee5c-4a58-a740-829f839af3b1",-3,18,-21,-0.024,15,16,31,"Negative","Regionen overtræder behandlingsgaranti - ledige tider i efteråret (2a2111ba-ee5c-4a58-a740-829f839af3b1)",2022-03-22 05:57:16,2022-03-22 05:57:16
"2a7da343-523e-4737-a489-a6b8f21793c3",-4,15,-19,-0.0547945205479452,7,14,21,"Negative","Odenses håndboldkvinder slår Randers og fortsætter stime (2a7da343-523e-4737-a489-a6b8f21793c3)",2022-02-09 19:29:25,2022-02-09 19:29:25
"2a877974-c5bb-4fb2-82aa-dbe7c6df30a3",16,29,-13,0.140350877192982,17,13,30,"Positive","SDU-professor er en af de mest citerede (2a877974-c5bb-4fb2-82aa-dbe7c6df30a3)",2022-01-28 08:31:55,2022-01-28 08:31:55
"2a881573-1652-457c-a967-8b789377b77e",4,21,-17,0.0421052631578947,14,14,28,"Positive","Tester ydeevnen: Letbanen fyldt med sand (2a881573-1652-457c-a967-8b789377b77e)",2022-02-04 20:57:06,2022-02-04 20:57:06
"2ab6493e-a27d-44ff-b5d4-8a61d8ff2ad6",-10,3,-13,-0.120481927710843,2,9,11,"Negative","Vandstanden falder hurtigt efter storm (2ab6493e-a27d-44ff-b5d4-8a61d8ff2ad6)",2022-01-31 06:27:05,2022-01-31 06:27:05
"2acb011e-6394-47e9-8918-20b8f0dd5f71",6,11,-5,0.127659574468085,5,4,9,"Positive","Tirsdagen er lun men grå (2acb011e-6394-47e9-8918-20b8f0dd5f71)",2022-02-15 06:53:23,2022-02-15 06:53:23
"2b0462da-f6b7-4f0a-b7f1-0cec9432e6a9",15,58,-43,0.0697674418604651,43,29,72,"Positive","Efter skideballe: Trafikstyrelsen risikerer fyringer og skærper tilsyn med låse på togvogne (2b0462da-f6b7-4f0a-b7f1-0cec9432e6a9)",2022-01-13 13:08:37,2022-01-13 13:08:37
"2b63dc4d-6c5f-467a-af7e-d26f2a832579",31,44,-13,0.23134328358209,27,9,36,"Positive","Helena var 25 år på Lindø: En gang blå, altid blå (2b63dc4d-6c5f-467a-af7e-d26f2a832579)",2022-01-20 10:01:00,2022-01-20 10:01:00
"2bd29a3e-042d-42d0-9769-9328f398ed32",-5,28,-33,-0.0340136054421769,19,23,42,"Negative","Omikron trækker stadig veksler på OUH: - Hygiejnen er vigtigere end nogensinde (2bd29a3e-042d-42d0-9769-9328f398ed32)",2022-02-17 14:49:31,2022-02-17 14:49:31
"2c10b2df-dc51-4b4e-ab67-749d5c8351c9",-29,47,-76,-0.151041666666667,31,38,69,"Negative","Hotelejer blev haglet ned - så gik lokale til modangreb (2c10b2df-dc51-4b4e-ab67-749d5c8351c9)",2022-02-02 20:02:12,2022-02-02 20:02:12
"2c2bde24-b482-469d-a68c-38fa487aac6f",2,16,-14,0.0232558139534884,9,10,19,"Positive","Skoler og dagtilbud kan snart droppe ugentlige test (2c2bde24-b482-469d-a68c-38fa487aac6f)",2022-02-11 12:22:13,2022-02-11 12:22:13
"2c482798-b3be-46f9-9249-fa2cf64df910",41,48,-7,0.366071428571429,29,7,36,"Positive","Rullende universitet ruller forbi Nyborg Gymnasium (2c482798-b3be-46f9-9249-fa2cf64df910)",2022-02-07 05:06:45,2022-02-07 05:06:45
"2ca2c200-ee28-4f18-a813-6fde2f808e32",-14,9,-23,-0.23728813559322,7,13,20,"Negative","Stormen Nora: Storebæltsbroen forbyder vindfølsomme køretøjer at passere (2ca2c200-ee28-4f18-a813-6fde2f808e32)",2022-02-19 06:13:23,2022-02-19 06:13:23
"2cb2f876-9eed-41e9-9d67-c5fa45fd2461",19,39,-20,0.108571428571429,26,13,39,"Positive","Russiske krigsskibe eskorteret ud af fynsk farvand (2cb2f876-9eed-41e9-9d67-c5fa45fd2461)",2022-01-18 14:21:50,2022-01-18 14:21:50
"2cfb5c48-5576-449d-a95f-4c81b3c3d02b",7,15,-8,0.104477611940299,10,5,15,"Positive","Ekspert: Høje energipriser ser ud til at fortsætte meget længe (2cfb5c48-5576-449d-a95f-4c81b3c3d02b)",2022-01-18 08:30:53,2022-01-18 08:30:53
"2cfba65a-3542-40fb-8ec0-db704ab278a5",-4,15,-19,-0.0727272727272727,7,9,16,"Negative","Tricktyve varetægtsfængslet: Snød sig til at stjæle kvindes pung (2cfba65a-3542-40fb-8ec0-db704ab278a5)",2022-03-19 11:10:05,2022-03-19 11:10:05
"2d536807-ea3e-4962-ad8b-003e9f198bea",29,77,-48,0.126637554585153,50,29,79,"Positive","Trods massivt fokus: Andelen af unge med erhvervsuddannelse falder (2d536807-ea3e-4962-ad8b-003e9f198bea)",2022-02-27 06:11:45,2022-02-27 06:11:45
"2d547264-bd2e-4017-86b8-2c61e508ffa6",-2,50,-52,-0.00793650793650794,39,32,71,"Negative","Kritik af fonde: Milliarder givet til udvikling af vacciner - problemet er et helt andet (2d547264-bd2e-4017-86b8-2c61e508ffa6)",2022-01-21 06:47:46,2022-01-21 06:47:46
"2d7542e4-bcef-4e00-8dc7-eb1871ea2f6a",8,26,-18,0.0776699029126214,19,13,32,"Positive","Smittetallet er det laveste i hele landet siden januar (2d7542e4-bcef-4e00-8dc7-eb1871ea2f6a)",2022-03-06 14:03:17,2022-03-06 14:03:17
"2daf04c9-9a0b-488f-83e2-0fbf22980eda",30,47,-17,0.263157894736842,32,9,41,"Positive","Ukrainske ansøgere kommer øverst i bunken hos fynsk virksomhed (2daf04c9-9a0b-488f-83e2-0fbf22980eda)",2022-03-18 09:41:55,2022-03-18 09:41:55
"2e2da254-38d4-4e3b-a9c1-3195b981de8f",32,39,-7,0.316831683168317,30,5,35,"Positive","Frivillige vil lukke hul i søassistance på den fynske kyst (2e2da254-38d4-4e3b-a9c1-3195b981de8f)",2022-02-05 17:15:51,2022-02-05 17:15:51
"2e58e4c7-51f6-40c2-9972-8817717779ca",-4,45,-49,-0.0222222222222222,30,28,58,"Negative","Formands bedrag til debat: - Hvis han kan lyve for konen, kan han også lyve for os (2e58e4c7-51f6-40c2-9972-8817717779ca)",2022-01-24 20:40:14,2022-01-24 20:40:14
"2ece08f6-b957-4895-96b0-0a6dbd78e51b",30,35,-5,0.252100840336134,24,4,28,"Positive","Nyt byggeri til 120 millioner kroner på vej på SDU (2ece08f6-b957-4895-96b0-0a6dbd78e51b)",2022-02-09 20:42:04,2022-02-09 20:42:04
"2f1b8290-e877-4d1b-aca5-9cc5af81b9fb",37,54,-17,0.190721649484536,41,14,55,"Positive","Folkeafstemning, udfasning af russisk gas og milliarder til Forsvaret - her er ""historisk aftale"" (2f1b8290-e877-4d1b-aca5-9cc5af81b9fb)",2022-03-07 05:36:49,2022-03-07 05:36:49
"30603077-5681-45f5-ad25-176488678972",-8,9,-17,-0.0898876404494382,9,11,20,"Negative","Største stigning i huspriser i 15 år: Sådan er priserne i din by (30603077-5681-45f5-ad25-176488678972)",2022-01-11 20:35:12,2022-01-11 20:35:12
"30850adb-49e0-4b6e-9d85-b7acfbed5451",-3,19,-22,-0.0288461538461538,13,16,29,"Negative","Medie: Epidemikommission vil holde natteliv lukket til februar (30850adb-49e0-4b6e-9d85-b7acfbed5451)",2022-01-12 07:15:06,2022-01-12 07:15:06
"3099553e-1abb-46f0-b5ac-4782fe3b8315",21,42,-21,0.16030534351145,25,13,38,"Positive","Kommune ønsker bedre overblik over ukrainske flygtninge (3099553e-1abb-46f0-b5ac-4782fe3b8315)",2022-03-11 06:40:47,2022-03-11 06:40:47
"30af5d93-546c-44e4-86c1-88ce465e441b",15,29,-14,0.111111111111111,22,6,28,"Positive","Langelændere sagde nej til udrejsecenter - nu bliver Holmegaard til asylcenter (30af5d93-546c-44e4-86c1-88ce465e441b)",2022-03-11 12:04:23,2022-03-11 12:04:23
"30d5ba8e-3ca5-411a-a4a0-c74c9c1a30f5",15,43,-28,0.112781954887218,30,20,50,"Positive","Natteravne efter tragiske sager: Lav aftaler og spørg om hjælp (30d5ba8e-3ca5-411a-a4a0-c74c9c1a30f5)",2022-02-16 18:44:11,2022-02-16 18:44:11
"30f216e8-e819-488d-891c-04b4d5016e87",73,107,-34,0.342723004694836,68,24,92,"Positive","Fossilfrit fynsk flybrændstof imponerer kronprinsen: - Det er en fantastisk oplevelse (30f216e8-e819-488d-891c-04b4d5016e87)",2022-03-14 14:11:45,2022-03-14 14:11:45
"313a49f8-eeb9-486c-a697-ac3bef6a4d93",1,6,-5,0.0192307692307692,4,5,9,"Positive","Onsdagens vejr starter solrigt på Fyn (313a49f8-eeb9-486c-a697-ac3bef6a4d93)",2022-02-23 05:37:32,2022-02-23 05:37:32
"3168296a-f5d6-4556-8862-1313ffa5326b",-19,10,-29,-0.191919191919192,7,19,26,"Negative","Undersøgelser færdige: Årsag til brand i gartneri fundet (3168296a-f5d6-4556-8862-1313ffa5326b)",2022-02-11 16:35:56,2022-02-11 16:35:56
"3175ad97-794e-4af6-9e62-826b514455aa",65,87,-22,0.433333333333333,58,18,76,"Positive","Millioner på vej til hjemmepleje i fynsk kommune (3175ad97-794e-4af6-9e62-826b514455aa)",2022-02-11 18:11:33,2022-02-11 18:11:33
"31b1244f-988b-428e-9615-6fd3d59dff39",27,31,-4,0.325301204819277,20,3,23,"Positive","A.P. Møller-millioner til unikt naturcenter på Fyn (31b1244f-988b-428e-9615-6fd3d59dff39)",2022-02-03 21:05:05,2022-02-03 21:05:05
"31d05448-09b7-4a60-aa91-6f372644114b",-1,16,-17,-0.0117647058823529,12,13,25,"Negative","Lørdagens coronatal: Smitten falder på landsplan - men stiger på Fyn (31d05448-09b7-4a60-aa91-6f372644114b)",2022-01-22 14:10:56,2022-01-22 14:10:56
"320fc734-b8d1-41f3-b118-0c8bf8076d7f",32,40,-8,0.293577981651376,31,4,35,"Positive","Fynboerne får ekstra skraldespand trods plan om fælles sorteringsanlæg (320fc734-b8d1-41f3-b118-0c8bf8076d7f)",2022-01-19 17:37:09,2022-01-19 17:37:09
"326def1b-967b-4033-9ea0-aab31df1b249",5,16,-11,0.0746268656716418,10,11,21,"Positive","Tirsdagens coronatal: Fortsat smittestigning på Fyn (326def1b-967b-4033-9ea0-aab31df1b249)",2022-02-08 14:17:23,2022-02-08 14:17:23
"329237de-90dd-4d5e-a178-6e8bc6c49401",-1,27,-28,-0.0106382978723404,16,21,37,"Negative","Dykkere fandt vaskemaskiner og løbehjul i havnen: - Hvis vi vil færdes i havet, skal vi passe på det (329237de-90dd-4d5e-a178-6e8bc6c49401)",2022-03-13 16:50:26,2022-03-13 16:50:26
"32e6fa27-d2db-410c-beb7-c1266e47ff51",37,39,-2,0.300813008130081,27,1,28,"Positive","Lastbil med fugletårn sad fast: - Ikke alt går efter planen (32e6fa27-d2db-410c-beb7-c1266e47ff51)",2022-02-09 20:01:08,2022-02-09 20:01:08
"332cf52a-56ba-45a7-a0c1-cafeb00ef237",19,42,-23,0.179245283018868,30,11,41,"Positive","Politikere om Holmegaard som 'buffer': Regeringen holder langelænderne på pinebænken (332cf52a-56ba-45a7-a0c1-cafeb00ef237)",2022-01-13 15:06:00,2022-01-13 15:06:00
"336da232-601e-4f6b-9ecb-3faaeadd328e",36,57,-21,0.232258064516129,32,13,45,"Positive","Tidligere generalsekretær om ny særlov: - Ukrainerne kan få en normalitet ind i tilværelsen (336da232-601e-4f6b-9ecb-3faaeadd328e)",2022-03-18 20:44:11,2022-03-18 20:44:11
"33da85fa-229e-4d53-a6f9-8459926e280f",14,16,-2,0.333333333333333,8,2,10,"Positive","50 år med Margrethe: Fortæl om dit møde med dronningen (33da85fa-229e-4d53-a6f9-8459926e280f)",2022-01-13 08:20:10,2022-01-13 08:20:10
"3408d87b-ddde-4d75-871b-5239891262ab",51,57,-6,0.408,36,4,40,"Positive","Falch om festival i Lars Høghs ånd: - Vi dyrker medmenneskelighed, venlighed og solidaritet (3408d87b-ddde-4d75-871b-5239891262ab)",2022-02-05 19:05:58,2022-02-05 19:05:58
"346700b1-51aa-4ddd-8e97-eda035a32da6",62,73,-11,0.579439252336449,46,7,53,"Positive","Middelfart-skole dystede med: Se hele finalen i Smart Parat Svar (346700b1-51aa-4ddd-8e97-eda035a32da6)",2022-02-02 20:05:00,2022-02-02 11:25:06
"34773594-62de-499b-92d3-ee39f8c736e6",-31,47,-78,-0.111111111111111,38,49,87,"Negative","Stor regning i lydfilssag afvises af læger (34773594-62de-499b-92d3-ee39f8c736e6)",2022-01-27 13:22:27,2022-01-27 13:22:27
"350c53e3-f0ee-41da-8773-85a4d6f198e1",-21,10,-31,-0.19811320754717,7,21,28,"Negative","Odense Å har den højeste vandstand i 80 år, men der er uenighed om årsagen (350c53e3-f0ee-41da-8773-85a4d6f198e1)",2022-02-23 19:13:10,2022-02-23 19:13:10
"351984da-15f5-4f57-a7f2-7f1f1b090560",-3,48,-51,-0.016304347826087,35,31,66,"Negative","Klimaforsker om nedslående prognose: - Hvor stor bliver prisen i fremtiden? (351984da-15f5-4f57-a7f2-7f1f1b090560)",2022-01-11 10:45:29,2022-01-11 10:45:29
"3538d042-de1a-4523-aa4d-746ed61ca791",10,24,-14,0.119047619047619,16,9,25,"Positive","Fynsk havneformand vil have forbud mod russiske skibe i danske havne (3538d042-de1a-4523-aa4d-746ed61ca791)",2022-03-12 13:08:16,2022-03-12 13:08:16
"355c3436-6e1a-4bec-9d5d-1aa427a56d0e",15,17,-2,0.245901639344262,10,2,12,"Positive","Mille Kieler Jensen kåret som Årets Fynske Fund (355c3436-6e1a-4bec-9d5d-1aa427a56d0e)",2022-03-12 15:27:01,2022-03-12 15:27:01
"35be44b3-7498-4411-a83f-2861183f858f",24,45,-21,0.154838709677419,31,15,46,"Positive","Omstridt motorcrossbane får igen ekstra penge af kommunen (35be44b3-7498-4411-a83f-2861183f858f)",2022-01-20 11:10:13,2022-01-20 11:10:13
"363b4da0-90ef-4fe5-9212-c2aba7e6d17c",-7,2,-9,-0.155555555555556,2,4,6,"Negative","Død mand fundet på bunden af havnebassin (363b4da0-90ef-4fe5-9212-c2aba7e6d17c)",2022-03-21 10:35:13,2022-03-21 10:35:13
"364d24af-6e34-4e29-bf75-a185333f8e44",11,47,-36,0.0578947368421053,39,26,65,"Positive","SDU oplever cybertrusler fra udenlandske hackere (364d24af-6e34-4e29-bf75-a185333f8e44)",2022-03-07 21:00:11,2022-03-07 21:00:11
"365db344-1ca9-4ce4-a633-3e5bcf7660ed",6,42,-36,0.04,30,20,50,"Positive","Fik stoppet udrejsecenter: Nu vil langelændere have flygtningecenter for ukrainere (365db344-1ca9-4ce4-a633-3e5bcf7660ed)",2022-02-25 07:59:00,2022-02-24 20:14:08
"3707f100-ead0-44f1-b246-a112ab0ff456",1,8,-7,0.0172413793103448,6,6,12,"Positive","Mangler du svar? Nu er der igen garanti for behandling inden for 30 dage (3707f100-ead0-44f1-b246-a112ab0ff456)",2022-01-21 17:12:39,2022-01-21 17:12:39
"37803dcc-f18f-4b5d-9e61-c723fd1e9a12",-1,6,-7,-0.0172413793103448,6,4,10,"Negative","To biler kører frontalt sammen på landevej (37803dcc-f18f-4b5d-9e61-c723fd1e9a12)",2022-02-08 20:52:00,2022-02-08 18:44:48
"37af1a19-3a55-44f0-a2a9-997d67c08fcc",52,68,-16,0.273684210526316,50,11,61,"Positive","Ny teknologi skal fange CO2: I fremtiden bliver fjernvarmen klimaneutral (37af1a19-3a55-44f0-a2a9-997d67c08fcc)",2022-01-17 13:00:08,2022-01-17 13:00:08
"37eee02e-bb1b-4d0a-b08f-6762aad1482e",1,16,-15,0.0114942528735632,10,8,18,"Positive","Holmegaard skal bruges som ""buffer"" for fremtidig asyltilstrømning (37eee02e-bb1b-4d0a-b08f-6762aad1482e)",2022-01-12 10:19:24,2022-01-12 10:19:24
"37fafac6-b4ea-4be5-964e-1d005f813a37",18,31,-13,0.152542372881356,20,9,29,"Positive","Christian Eriksen får Brentford-debut lørdag, lover træner (37fafac6-b4ea-4be5-964e-1d005f813a37)",2022-02-25 14:11:34,2022-02-25 14:11:34
"381c52e9-a257-4fbf-a93f-27abaee41140",13,31,-18,0.116071428571429,25,11,36,"Positive","Eriksen får ingen særbehandling til træning i Brentford (381c52e9-a257-4fbf-a93f-27abaee41140)",2022-02-04 06:21:24,2022-02-04 06:21:24
"38248282-97da-494c-b15f-f24ceb7d8e4b",72,83,-11,0.373056994818653,48,7,55,"Positive","International sportsweekend på Fyn: - Vi har været i en kummefryser i næsten to år (38248282-97da-494c-b15f-f24ceb7d8e4b)",2022-03-05 18:49:56,2022-03-05 18:49:56
"38489c4e-7c85-422c-8ff1-c62771eb8e01",18,26,-8,0.315789473684211,12,6,18,"Positive","Endnu en forårsdag i vente (38489c4e-7c85-422c-8ff1-c62771eb8e01)",2022-03-22 06:03:42,2022-03-22 06:03:42
"384f2d88-ff03-410e-93e4-93669de31b39",-11,6,-17,-0.126436781609195,6,10,16,"Negative","Sort røg i Nyborg: Brand er slukket - en person er kørt på skadestuen (384f2d88-ff03-410e-93e4-93669de31b39)",2022-03-15 14:58:00,2022-03-15 13:08:40
"384fca6e-08b5-408c-97cc-09d1e42da386",44,74,-30,0.287581699346405,44,22,66,"Positive","Odense skraber bunden i antallet af unge på erhvervsuddannelse (384fca6e-08b5-408c-97cc-09d1e42da386)",2022-03-02 15:28:56,2022-03-02 15:28:56
"386836f7-6fa6-48df-9b8b-cc2f3039a5c3",3,8,-5,0.0535714285714286,6,3,9,"Positive","Se billederne: Ukrainske flygtninge venter på banegården i Krakow (386836f7-6fa6-48df-9b8b-cc2f3039a5c3)",2022-03-03 13:52:06,2022-03-03 13:52:06
"38b251aa-e29f-4238-8f77-6e821ebeef22",4,25,-21,0.03125,20,13,33,"Positive","Tre fratræder efter uregelmæssigheder på Særslev-Hårslev Skolen (38b251aa-e29f-4238-8f77-6e821ebeef22)",2022-01-11 11:48:25,2022-01-11 11:48:25
"38fae2aa-5c4e-4f04-a7f8-a2e24af608e1",2,22,-20,0.0181818181818182,17,17,34,"Positive","Transportudgifterne stiger: Fynbus frygter at mangle busser (38fae2aa-5c4e-4f04-a7f8-a2e24af608e1)",2022-03-10 21:18:07,2022-03-10 21:18:07
"3908d7a0-259a-4257-9c3d-b1b8c18d878f",-8,7,-15,-0.145454545454545,5,13,18,"Negative","Det bliver dyrt at handle og spise: Fem gode råd til at spare på madbudgettet (3908d7a0-259a-4257-9c3d-b1b8c18d878f)",2022-03-13 19:12:58,2022-03-13 19:12:58
"3945b3d0-15cc-41bf-a266-3615b91de376",18,93,-75,0.0559006211180124,63,44,107,"Positive","Flere ældre, færre hænder: Er ledige som Tililia en del af løsningen? (3945b3d0-15cc-41bf-a266-3615b91de376)",2022-01-17 18:15:17,2022-01-17 18:15:17
"3a546d23-2470-40f7-a529-24422fa75339",3,27,-24,0.0309278350515464,17,17,34,"Positive","Fynsk koldkrigsekspert: Putin vil have Nato væk fra Ruslands grænser (3a546d23-2470-40f7-a529-24422fa75339)",2022-02-25 05:46:01,2022-02-25 05:46:01
"3a613610-29ab-4f63-8c5a-6f38ca9eeb4c",14,31,-17,0.111111111111111,22,12,34,"Positive","Geder erstatter græsslåmaskiner i Nyborg (3a613610-29ab-4f63-8c5a-6f38ca9eeb4c)",2022-03-08 05:19:36,2022-03-08 05:19:36
"3a8e301e-9ecf-4793-90a7-44e836bc3990",8,14,-6,0.166666666666667,11,3,14,"Positive","Se debatten: Hvad skal der ske med Nyborg Slot? (3a8e301e-9ecf-4793-90a7-44e836bc3990)",2022-02-24 15:53:01,2022-02-24 15:53:01
"3a9230ec-14cb-41d9-9f27-6892aae54aeb",19,39,-20,0.1484375,27,13,40,"Positive","Borgmester på Langeland: - Ikke en smertefri opgave, men vi løser det (3a9230ec-14cb-41d9-9f27-6892aae54aeb)",2022-03-11 16:46:24,2022-03-11 16:46:24
"3ab8b4a6-3243-4880-8a43-f4da9fd2a4a7",30,40,-10,0.303030303030303,23,4,27,"Positive","Mathias Gidsel nomineret som verdens bedste (3ab8b4a6-3243-4880-8a43-f4da9fd2a4a7)",2022-02-28 09:44:40,2022-02-28 09:44:40
"3ae7d942-20a1-437a-9349-ee1b22dcc5ae",5,9,-4,0.0847457627118644,9,2,11,"Positive","Politiet efterforsker stadig: Forsvundet 13-årig er genforenet med sin mor (3ae7d942-20a1-437a-9349-ee1b22dcc5ae)",2022-02-25 14:27:29,2022-02-25 14:27:29
"3b0043ae-4574-4403-9654-f932c1b23b67",19,27,-8,0.27536231884058,16,4,20,"Positive","GOG-talent smutter til Tyskland til sommer (3b0043ae-4574-4403-9654-f932c1b23b67)",2022-01-21 15:19:26,2022-01-21 15:19:26
"3b660237-83af-4f88-ae65-720a69a4b31d",-6,87,-93,-0.0257510729613734,56,49,105,"Negative","Fynboer får svar: Den russiske befolkning styres med propaganda (3b660237-83af-4f88-ae65-720a69a4b31d)",2022-03-14 21:13:00,2022-03-08 21:08:07
"3b695a13-bdde-4cd1-ac6a-adb581a2640c",-1,9,-10,-0.0133333333333333,7,7,14,"Negative","Smitten falder for tredje dag i træk - se udviklingen i din kommune her (3b695a13-bdde-4cd1-ac6a-adb581a2640c)",2022-02-04 13:52:21,2022-02-04 13:52:21
"3cb058ee-4346-4bd8-9aba-481473f01e95",30,61,-31,0.144230769230769,42,18,60,"Positive","Fynske DF’ere revser Messerschmidt: - Han skulle aldrig have været formand (3cb058ee-4346-4bd8-9aba-481473f01e95)",2022-02-22 10:05:25,2022-02-22 10:05:25
"3ccf23a5-edf3-42d5-a501-7e99c5070419",48,76,-28,0.375,53,17,70,"Positive","Organisation undrer sig: Hvorfor har A.P. Møller Fonden ikke trukket støtte noget før? (3ccf23a5-edf3-42d5-a501-7e99c5070419)",2022-02-09 18:49:43,2022-02-09 18:49:43
"3cfdd172-36bb-49b1-b794-d1320701f176",-9,13,-22,-0.0782608695652174,13,16,29,"Negative","Kommunaldirektør i Nyborg sygemeldt med stress (3cfdd172-36bb-49b1-b794-d1320701f176)",2022-02-23 16:17:12,2022-02-23 16:17:12
"3d5f938e-0d2d-4744-84b4-80c3cb8345b9",14,32,-18,0.145833333333333,25,10,35,"Positive","Efter seks forlængelser: Nu er det slut med visitationszone i Vollsmose og Korsløkke (3d5f938e-0d2d-4744-84b4-80c3cb8345b9)",2022-02-15 14:51:42,2022-02-15 14:51:42
"3d68e32f-ad0e-45eb-8ce0-bcd5e753cac0",4,16,-12,0.0481927710843374,11,7,18,"Positive","Otte personer anholdt i forbindelse med muligt skyderi i Vollsmose (3d68e32f-ad0e-45eb-8ce0-bcd5e753cac0)",2022-01-12 16:57:00,2022-01-12 15:05:29
"3d82cf26-97f3-448c-96f2-eaedcc33b72f",9,17,-8,0.101123595505618,10,8,18,"Positive","Endelig på Fyn: Flygtninge ånder lettet op (3d82cf26-97f3-448c-96f2-eaedcc33b72f)",2022-03-04 11:20:46,2022-03-04 11:20:46
"3dabcdf3-c69d-40f6-bca7-e863291d5ff9",6,40,-34,0.0346820809248555,24,24,48,"Positive","Markant smittestigning blandt pædagoger og lærere (3dabcdf3-c69d-40f6-bca7-e863291d5ff9)",2022-02-03 20:02:12,2022-02-03 20:02:12
"3e1bc40c-9ab6-486a-80d0-6ef1b93c4848",-23,22,-45,-0.139393939393939,16,29,45,"Negative","Dyrere brød og kager: - Jeg bliver ked af, at jeg skal pålægge mine kunder den byrde (3e1bc40c-9ab6-486a-80d0-6ef1b93c4848)",2022-03-13 18:17:28,2022-03-13 18:17:28
"3e74c4ca-6366-481f-a807-5d560765546e",45,56,-11,0.36,34,7,41,"Positive","Eriksen forklarer: Derfor valgte jeg Brentford (3e74c4ca-6366-481f-a807-5d560765546e)",2022-02-08 06:42:35,2022-02-08 06:42:35
"3eb96022-6d66-4d40-8af0-434eb7307f75",-22,17,-39,-0.132530120481928,14,26,40,"Negative","Otte gange er det nær gået galt: Nu advarer SDU de studerende (3eb96022-6d66-4d40-8af0-434eb7307f75)",2022-02-10 18:10:35,2022-02-10 18:10:35
"3ec6f633-5945-49de-a464-35085d976ab4",-6,37,-43,-0.0458015267175573,25,26,51,"Negative","Driftsdirektør om svindeltiltalt fynsk vognmandsfamilie: - Det er vores image, det går ud over (3ec6f633-5945-49de-a464-35085d976ab4)",2022-03-16 10:22:37,2022-03-16 10:22:37
"3ec9127a-cfdf-422b-9362-06e4320cfe55",10,15,-5,0.232558139534884,9,5,14,"Positive","Blæsende torsdag med kraftige vindstød i vente (3ec9127a-cfdf-422b-9362-06e4320cfe55)",2022-01-13 06:34:15,2022-01-13 06:34:15
"3ef3df38-485e-4ac5-bece-71e010a605b5",12,18,-6,0.173913043478261,10,4,14,"Positive","Her er de nominerede til Årets Fynske Sportsnavn (3ef3df38-485e-4ac5-bece-71e010a605b5)",2022-03-06 14:32:26,2022-03-06 14:32:26
"3ef696ad-ee49-4067-b76c-7ef6d4169d02",2,48,-46,0.0130718954248366,27,27,54,"Positive","Overlegen Axelsen banker inder og vinder All England (3ef696ad-ee49-4067-b76c-7ef6d4169d02)",2022-03-20 17:19:59,2022-03-20 17:19:59
"3f308197-e7cf-48ae-a420-f7d43750296c",7,36,-29,0.0463576158940397,24,16,40,"Positive","Droppet som folketingskandidat: Fynsk DF'er forlader partiet efter uro (3f308197-e7cf-48ae-a420-f7d43750296c)",2022-02-23 14:45:43,2022-02-23 14:45:43
"3fde8244-2567-447b-b8d7-a618962d0c14",7,49,-42,0.0445859872611465,28,34,62,"Positive","Corona aflyste seks kampe: Bulldogs kom endelig på is igen og vandt (3fde8244-2567-447b-b8d7-a618962d0c14)",2022-01-09 19:30:10,2022-01-09 19:30:10
"4005c39e-dad6-46ee-8c17-440f2ba82dbf",-1,11,-12,-0.0147058823529412,7,10,17,"Negative","Isglatte veje på store dele af Fyn (4005c39e-dad6-46ee-8c17-440f2ba82dbf)",2022-02-12 06:40:50,2022-02-12 06:40:50
"4037511d-6cd4-468a-8732-0cb31832c7b8",35,44,-9,0.321100917431193,30,7,37,"Positive","Odenses nye fodbolddirektør: - Vi skal være en sælgende klub (4037511d-6cd4-468a-8732-0cb31832c7b8)",2022-01-10 18:14:30,2022-01-10 18:14:30
"40756086-07ea-4ecf-97f4-3f1887e66b6f",-22,24,-46,-0.165413533834586,17,25,42,"Negative","Ukrainer på Fyn er dybt berørt: - Jeg har snakket med min far om, at måske tales vi ved - måske gør vi ikke (40756086-07ea-4ecf-97f4-3f1887e66b6f)",2022-02-24 21:46:37,2022-02-24 21:46:37
"40e2920c-f5e1-4c67-b7ca-e38ab3404477",21,37,-16,0.169354838709677,26,11,37,"Positive","Virksomheder får afslag på stribe - skoler kan ikke skaffe lærlinge nok (40e2920c-f5e1-4c67-b7ca-e38ab3404477)",2022-02-17 18:53:28,2022-02-17 18:53:28
"412eb995-2b21-4460-81c0-8d1f0020edc1",38,78,-40,0.168888888888889,53,26,79,"Positive","Hvad vil du vide om krigen i Ukraine? Eksperter er klar med svar (412eb995-2b21-4460-81c0-8d1f0020edc1)",2022-03-04 17:33:48,2022-03-04 17:33:48
"41665c99-5913-497b-bbb8-42ce1a1d21e0",26,51,-25,0.148571428571429,37,18,55,"Positive","En renovering, en flytning eller en nedlæggelse: Hvad skal der ske med friluftsbadet? (41665c99-5913-497b-bbb8-42ce1a1d21e0)",2022-02-11 08:40:14,2022-02-11 08:40:14
"42085758-678e-41fb-bc71-0c1ff3b9b02f",24,43,-19,0.1875,30,14,44,"Positive","Ildsjæle fik idé under nedlukning: Nu er de tæt på målet (42085758-678e-41fb-bc71-0c1ff3b9b02f)",2022-02-14 12:09:04,2022-02-14 12:09:04
"42423b64-66e4-46ab-a1b0-cdbe0a124bc5",-11,3,-14,-0.224489795918367,3,9,12,"Negative","Torsdagens coronatal: Færre smittede på Fyn (42423b64-66e4-46ab-a1b0-cdbe0a124bc5)",2022-01-13 13:58:34,2022-01-13 13:58:34
"42fedf2a-6a0d-416c-8eb2-8eafe0d756f2",-4,18,-22,-0.0380952380952381,12,15,27,"Negative","Sundhedsministeren taler om skadestuer oversvømmet med fulde unge - det genkender de slet ikke på OUH (42fedf2a-6a0d-416c-8eb2-8eafe0d756f2)",2022-03-17 07:37:53,2022-03-17 07:37:53
"43b23a3b-127e-410d-8f9e-ab0a57bde961",5,17,-12,0.0757575757575758,10,6,16,"Positive","Stille og flot fredag før blæsende weekend (43b23a3b-127e-410d-8f9e-ab0a57bde961)",2022-01-28 05:19:13,2022-01-28 05:19:13
"43de2404-76cd-4788-bd32-3b04048a2086",11,37,-26,0.088,31,14,45,"Positive","Arrangør af russisk ballet: - Vi kan ikke bare aflyse forestillingerne (43de2404-76cd-4788-bd32-3b04048a2086)",2022-02-26 13:45:16,2022-02-26 13:45:16
"441de13a-124a-403a-9515-8bc7ae544dd0",-10,6,-16,-0.136986301369863,5,13,18,"Negative","Årets første forårsdag bliver gråt i gråt (441de13a-124a-403a-9515-8bc7ae544dd0)",2022-03-01 06:10:01,2022-03-01 06:10:01
"4444edc9-c824-4ce2-87d6-84a45734d806",9,20,-11,0.09375,14,10,24,"Positive","OB sender landsholdsspiller til 1. divisionsklub (4444edc9-c824-4ce2-87d6-84a45734d806)",2022-01-24 19:07:52,2022-01-24 19:07:52
"444f941e-6631-4cc1-8edd-e08efe1e7b97",-4,13,-17,-0.0470588235294118,9,15,24,"Negative","Tirsdag ryger mundbind og krav om coronapas (444f941e-6631-4cc1-8edd-e08efe1e7b97)",2022-01-26 17:11:43,2022-01-26 17:11:43
"4477aff8-28b1-4dac-a9c2-658725ff6eb2",-6,0,-6,-0.146341463414634,0,5,5,"Negative","Følg pressemødet om coronarestriktionerne direkte (4477aff8-28b1-4dac-a9c2-658725ff6eb2)",2022-01-26 17:30:00,2022-01-26 17:30:00
"44fffb0f-2922-46cd-8962-65d8577f3e44",-7,10,-17,-0.12280701754386,6,11,17,"Negative","GOG lider første liganederlag i 263 dage (44fffb0f-2922-46cd-8962-65d8577f3e44)",2022-02-25 20:29:10,2022-02-25 20:29:10
"4561219e-326a-4505-85f1-660c1180f568",28,39,-11,0.194444444444444,30,9,39,"Positive","Byråd vil have tidsplan: Massiv udbygning af fjernvarmen i Middelfart (4561219e-326a-4505-85f1-660c1180f568)",2022-03-17 13:43:11,2022-03-17 13:43:11
"456c352c-6521-476b-972d-4bb2f6055abc",11,43,-32,0.0859375,25,22,47,"Positive","Odense slår trætte rivaler og bliver i toppen (456c352c-6521-476b-972d-4bb2f6055abc)",2022-02-02 20:35:50,2022-02-02 20:35:50
"459e91d3-6bae-434c-87ec-ba69b9076a8b",14,43,-29,0.106060606060606,33,19,52,"Positive","Forslag: Check på vej til danskere ramt af høje energipriser (459e91d3-6bae-434c-87ec-ba69b9076a8b)",2022-01-27 06:18:52,2022-01-27 06:18:52
"45ca241d-3447-418d-8207-5724528f93f4",1,8,-7,0.00943396226415094,6,6,12,"Positive","To fynske unge fortsat savnet: Nu er de efterlyst internationalt (45ca241d-3447-418d-8207-5724528f93f4)",2022-02-22 14:13:10,2022-02-22 14:13:10
"4627eb85-e895-4f45-8785-5f7140022a62",7,30,-23,0.0619469026548673,20,13,33,"Positive","Stor fynsk opbakning til naturnationalparker (4627eb85-e895-4f45-8785-5f7140022a62)",2022-02-10 08:04:12,2022-02-10 08:04:12
"46455c21-515e-4201-a062-ed9ad039b1ee",-14,13,-27,-0.120689655172414,13,18,31,"Negative","Ulovligt og generende: Stort antal fik bøde for at cykle i gågade (46455c21-515e-4201-a062-ed9ad039b1ee)",2022-02-11 19:30:11,2022-02-11 19:30:11
"46af11ed-caca-42ee-b995-b1d0123f9968",5,29,-24,0.0333333333333333,22,15,37,"Positive","Bare rolig, det er ikke russerne: Natflyvning over Odense er en øvelse (46af11ed-caca-42ee-b995-b1d0123f9968)",2022-02-10 10:46:56,2022-02-10 10:46:56
"46d054a3-1790-4475-868f-d6f0343e5d79",1,17,-16,0.010752688172043,11,13,24,"Positive","Krisemøde i fiskeriforening: - Det ser meget sort ud (46d054a3-1790-4475-868f-d6f0343e5d79)",2022-01-13 20:34:13,2022-01-13 20:34:13
"46e77415-49ac-45b5-a068-fa23a815721b",7,42,-35,0.0424242424242424,32,29,61,"Positive","SDU klar til at indfri statsministerens nytårsønske: Grønt flybrændstof på vej (46e77415-49ac-45b5-a068-fa23a815721b)",2022-01-17 17:40:46,2022-01-17 17:40:46
"47056431-3046-4fc3-b1b7-98127690e1f7",11,53,-42,0.094017094017094,31,21,52,"Positive","Gidsel før EM-opgør: - Vi skal hanke op i os selv (47056431-3046-4fc3-b1b7-98127690e1f7)",2022-01-15 09:28:09,2022-01-15 09:28:09
"47180800-3931-479f-a515-f5a4e2fcc84a",0,12,-12,0,7,10,17,"Negative","Tåget morgen bliver til solrig torsdag (47180800-3931-479f-a515-f5a4e2fcc84a)",2022-03-10 06:34:21,2022-03-10 06:34:21
"474bd731-c456-4177-86cd-31a047d5858c",4,27,-23,0.032258064516129,16,14,30,"Positive","Ikke vores krig: Russiske sømænd i Assens dybt berørt (474bd731-c456-4177-86cd-31a047d5858c)",2022-03-09 13:02:13,2022-03-09 13:02:13
"481c447a-4e4f-4340-a5f9-96d8ef92ca9b",0,32,-32,0,28,27,55,"Negative","Odense Zoo under debat: - Vores dyrepasser gør det megabesværligt at være dyr (481c447a-4e4f-4340-a5f9-96d8ef92ca9b)",2022-01-28 21:18:30,2022-01-28 21:18:30
"489810e4-147f-4e61-a4ee-b3938491bd31",39,54,-15,0.232142857142857,37,9,46,"Positive","Fynsk biskop: Dåbsritualet skal genovervejes i folkekirken (489810e4-147f-4e61-a4ee-b3938491bd31)",2022-02-07 17:45:07,2022-02-07 17:45:07
"48dd0c80-b3c4-4bbd-8311-55ef38708a98",7,52,-45,0.0378378378378378,38,23,61,"Positive","Odense siger nej til russisk ballet, men ja til kunst: - Vi skal passe på, at sanktioner af Putin ikke bliver censur af russerne (48dd0c80-b3c4-4bbd-8311-55ef38708a98)",2022-03-20 18:44:58,2022-03-20 18:44:58
"492f6cfb-0d42-4034-bb75-80702a1d67e1",37,56,-19,0.2,37,18,55,"Positive","OB fyrer sportschef (492f6cfb-0d42-4034-bb75-80702a1d67e1)",2022-02-28 18:01:43,2022-02-28 18:01:43
"49c07fde-20d6-4f2d-9eea-2cc0c8c5635a",12,19,-7,0.134831460674157,13,6,19,"Positive","Se tal for dit sogn: Lille stigning i smitten på Fyn (49c07fde-20d6-4f2d-9eea-2cc0c8c5635a)",2022-01-31 13:37:24,2022-01-31 13:37:24
"49c1e0b7-c520-41d4-83b6-77df28c1fdc4",15,17,-2,0.238095238095238,10,1,11,"Positive","Se de flotte billeder: Sand fra Sahara farver Fyn rød (49c1e0b7-c520-41d4-83b6-77df28c1fdc4)",2022-03-17 17:04:13,2022-03-17 17:04:13
"49d27106-363d-41c0-8230-c5eec3486244",-20,63,-83,-0.0651465798045603,46,55,101,"Negative","Priserne stiger: Flæskestegen og frikadellerne bliver det næste (49d27106-363d-41c0-8230-c5eec3486244)",2022-03-13 09:40:58,2022-03-13 09:40:58
"4adcc746-c670-4885-9535-72d38d079cef",24,43,-19,0.186046511627907,31,15,46,"Positive","Rektor håber på at få rabat for udflytninger (4adcc746-c670-4885-9535-72d38d079cef)",2022-01-13 19:02:08,2022-01-13 19:02:08
"4b26d890-6a1b-43e5-81dc-7389f556bc51",-8,6,-14,-0.131147540983607,5,7,12,"Negative","Mindehøjtidelighed i Odense efter skuddrab på 19-årig mand (4b26d890-6a1b-43e5-81dc-7389f556bc51)",2022-02-28 10:53:09,2022-02-28 10:53:09
"4b3c6be3-4c31-4c8a-aec0-e3a1d799ace1",-13,6,-19,-0.185714285714286,5,11,16,"Negative","Internt opgør udløste knivstikkeri i Granparken (4b3c6be3-4c31-4c8a-aec0-e3a1d799ace1)",2022-01-29 08:27:11,2022-01-29 08:27:11
"4b5c9cad-b861-471a-a07e-d47becfc1d26",7,22,-15,0.0909090909090909,12,8,20,"Positive","Kraftigt blæsevejr afløses af smuk solskinsdag (4b5c9cad-b861-471a-a07e-d47becfc1d26)",2022-01-17 05:44:09,2022-01-17 05:44:09
"4b867b2c-96ef-453b-b014-bb9e1ba04bda",43,46,-3,0.457446808510638,29,2,31,"Positive","Odense Letbane skifter direktør - igen (4b867b2c-96ef-453b-b014-bb9e1ba04bda)",2022-02-16 11:29:54,2022-02-16 11:29:54
"4c0b90e4-ab07-43da-9ed2-b3b16a31b311",5,10,-5,0.05,6,5,11,"Positive","Staten sælger enormt forsøgslandbrug på Fyn (4c0b90e4-ab07-43da-9ed2-b3b16a31b311)",2022-03-08 13:13:31,2022-03-08 13:13:31
"4c46ec8d-b517-4f25-8b4e-196309aceb5c",-6,3,-9,-0.113207547169811,3,5,8,"Negative","Klimakrisen fylder: Grønne gymnasieelever rykkede for bæredygtighedens skyld (4c46ec8d-b517-4f25-8b4e-196309aceb5c)",2022-03-16 10:00:17,2022-03-16 10:00:17
"4c500f2e-f33d-4a9a-bda9-893ef9268451",27,99,-72,0.0841121495327103,74,38,112,"Positive","Grønnelys lejere skuffet over kommunen: - Det virker useriøst, at man ikke har tjekket tingene (4c500f2e-f33d-4a9a-bda9-893ef9268451)",2022-02-01 07:00:22,2022-02-01 07:00:22
"4c5abc4f-091f-44cc-b11c-9c6cbbea1407",-5,3,-8,-0.128205128205128,3,5,8,"Negative","Onsdag holder det grå og våde vejr pause (4c5abc4f-091f-44cc-b11c-9c6cbbea1407)",2022-02-02 05:45:50,2022-02-02 05:45:50
"4c68a841-b853-4b36-8315-000a2ad84b78",18,32,-14,0.169811320754717,25,11,36,"Positive","Coronasmittede partnere må gerne være med til fødsel (4c68a841-b853-4b36-8315-000a2ad84b78)",2022-01-24 07:06:20,2022-01-24 07:06:20
"4c6b6802-6744-4edd-975b-fa73d42bf8a7",-23,33,-56,-0.185483870967742,25,36,61,"Negative","Dyrenes Beskyttelse kimes ned: Enlige sæler på land er ikke nød (4c6b6802-6744-4edd-975b-fa73d42bf8a7)",2022-02-10 16:50:46,2022-02-10 16:50:46
"4cc5921a-0240-4fb0-801b-578eb9c273e1",32,48,-16,0.290909090909091,25,11,36,"Positive","Filmproduktion søger 'brunt' hus i Nyborg - kender du det perfekte sted? (4cc5921a-0240-4fb0-801b-578eb9c273e1)",2022-01-30 14:33:42,2022-01-30 14:33:42
"4cd577e7-a313-406c-b9c0-cbb323623d7c",41,84,-43,0.146428571428571,69,23,92,"Positive","Eksperter tror på flere militære opgaver til Hjemmeværnet: - Deres image er ufortjent (4cd577e7-a313-406c-b9c0-cbb323623d7c)",2022-03-08 11:32:22,2022-03-08 11:32:22
"4d09f99b-7a5c-43b6-8e59-96fc6e5f1b5d",-5,4,-9,-0.0757575757575758,4,6,10,"Negative","Sonja Marie Jensen er langtidssygemeldt (4d09f99b-7a5c-43b6-8e59-96fc6e5f1b5d)",2022-02-07 18:54:26,2022-02-07 18:54:26
"4d12cdce-b36b-46e2-83e8-e0e9e3ee59b8",9,24,-15,0.0818181818181818,17,10,27,"Positive","Fynboer samler ind til Ukraine: - Vi kører gerne hver weekend (4d12cdce-b36b-46e2-83e8-e0e9e3ee59b8)",2022-02-28 05:37:14,2022-02-28 05:37:14
"4d560bdb-24da-4b3c-bc4a-c81aec371deb",14,37,-23,0.148936170212766,21,14,35,"Positive","Odense-keeper efter ydmygelse: - Vi er ikke bedre lige nu (4d560bdb-24da-4b3c-bc4a-c81aec371deb)",2022-02-28 11:01:12,2022-02-28 11:01:12
"4d57e0e9-c648-4f90-ab0c-244844dcad6a",5,10,-5,0.108695652173913,6,4,10,"Positive","Pæn mandag og mere mildt vejr på vej (4d57e0e9-c648-4f90-ab0c-244844dcad6a)",2022-01-10 05:51:17,2022-01-10 05:51:17
"4da36c27-a25e-4050-afc8-b591840339e8",17,23,-6,0.223684210526316,14,5,19,"Positive","Australsk landsholdsspiller tjekker ind hos OB (4da36c27-a25e-4050-afc8-b591840339e8)",2022-01-29 09:00:24,2022-01-29 09:00:24
"4dc7cc20-8083-4b57-bf7f-8f5411f8fa5a",18,52,-34,0.134328358208955,30,19,49,"Positive","Politikere blander sig i debatten: Må præster afvise homoseksuelle? (4dc7cc20-8083-4b57-bf7f-8f5411f8fa5a)",2022-02-08 15:45:07,2022-02-08 15:45:07
"4e03b8df-f618-402a-a6ed-2e926694eb40",24,56,-32,0.130434782608696,32,20,52,"Positive","Eriksen fik stadion til at rejse sig i svært comeback (4e03b8df-f618-402a-a6ed-2e926694eb40)",2022-02-26 17:08:34,2022-02-26 17:08:34
"4e2bd6c6-2fad-4ffb-9804-83caa421b46c",-3,7,-10,-0.0612244897959184,6,5,11,"Negative","Seks ud af otte løsladt efter muligt skyderi i Vollsmose (4e2bd6c6-2fad-4ffb-9804-83caa421b46c)",2022-01-13 07:31:13,2022-01-13 07:31:13
"4e2e0fb1-858f-40ec-984d-13e03449c7e6",22,58,-36,0.111111111111111,42,31,73,"Positive","Fynsk reaktion på trussel om gasmangel: - Vi skal væk fra Putins fossile gas (4e2e0fb1-858f-40ec-984d-13e03449c7e6)",2022-03-07 19:45:09,2022-03-07 19:45:09
"4e8ee9be-cbc8-4410-a68e-d343d68c7aa9",-13,15,-28,-0.136842105263158,13,14,27,"Negative","Forlænget for sjette gang: Se, hvad politiet har fundet på personer i Vollsmose (4e8ee9be-cbc8-4410-a68e-d343d68c7aa9)",2022-02-01 15:10:54,2022-02-01 15:10:54
"4ecebbf8-6638-4fa4-a4da-1db975af9154",18,27,-9,0.15,15,6,21,"Positive","Ekspert: Derfor er Bramsen som transportminister gode nyheder for Fyn (4ecebbf8-6638-4fa4-a4da-1db975af9154)",2022-02-04 12:49:39,2022-02-04 12:49:39
"4efebbbc-eec8-4559-b7a1-a6b10096fb24",8,16,-8,0.0879120879120879,14,5,19,"Positive","Højt antal bolighandler kan synge på sidste vers (4efebbbc-eec8-4559-b7a1-a6b10096fb24)",2022-02-16 17:34:06,2022-02-16 17:34:06
"4f0fc37b-19b2-4e3b-83ec-8845cd60d2ba",-6,12,-18,-0.0530973451327434,8,15,23,"Negative","Brændstofpriser på himmelflugt: Så meget dyrere er det blevet for fynboer at køre på arbejde (4f0fc37b-19b2-4e3b-83ec-8845cd60d2ba)",2022-03-10 16:22:59,2022-03-10 16:22:59
"4f75a7c6-b4e5-4add-9ad8-da19eea9787c",8,33,-25,0.0661157024793388,22,11,33,"Positive","Lav ledighed: Fagbevægelse hilser udenlandsk arbejdskraft velkommen (4f75a7c6-b4e5-4add-9ad8-da19eea9787c)",2022-01-11 18:28:14,2022-01-11 18:28:14
"4f792852-ff08-4f64-be7e-39e21280b2fc",-4,8,-12,-0.0769230769230769,3,8,11,"Negative","Solen kan kigge frem flere steder tirsdag (4f792852-ff08-4f64-be7e-39e21280b2fc)",2022-01-11 06:31:58,2022-01-11 06:31:58
"4f8cffc6-83b3-41b5-a25f-543559492787",27,54,-27,0.209302325581395,34,20,54,"Positive","Ekspert: Eriksen skal vænne sig til at tabe mere (4f8cffc6-83b3-41b5-a25f-543559492787)",2022-01-31 12:18:47,2022-01-31 12:18:47
"4f8dc321-b616-455d-98eb-f06586535b90",-6,12,-18,-0.0689655172413793,7,15,22,"Negative","OB får bøde efter Lars Høgh-hyldest (4f8dc321-b616-455d-98eb-f06586535b90)",2022-01-11 07:27:03,2022-01-11 07:27:03
"4f9cdb45-9320-4238-bf2b-6583ac3b873f",4,9,-5,0.0533333333333333,7,4,11,"Positive","Det fine forårsvejr fortsætter: Marts er tæt på at slå rekorden (4f9cdb45-9320-4238-bf2b-6583ac3b873f)",2022-03-15 05:51:18,2022-03-15 05:51:18
"4fb0a59a-866f-4d40-a238-fd623a7d3d41",14,26,-12,0.155555555555556,18,8,26,"Positive","Fyns Politi ophæver visitationszone efter skuddrab (4fb0a59a-866f-4d40-a238-fd623a7d3d41)",2022-03-15 10:51:35,2022-03-15 10:51:35
"4fe1ec5b-097a-474e-a950-d892cdb55237",19,56,-37,0.111764705882353,40,29,69,"Positive","Eksperter foreslår hurtigere grønt coronapas efter smitte (4fe1ec5b-097a-474e-a950-d892cdb55237)",2022-01-25 09:18:20,2022-01-25 09:18:20
"4aa5d760-1fde-4c7c-8570-36454438ad11",-1,5,-6,-0.0208333333333333,4,5,9,"Negative","Foråret får fat mandag morgen (4aa5d760-1fde-4c7c-8570-36454438ad11)",2022-03-21 07:33:48,2022-03-21 07:33:48
"502c8c41-dffc-42dd-98ef-006d6d123341",11,33,-22,0.0887096774193548,25,19,44,"Positive","Høje brændstofpriser får bilister til at ændre vaner (502c8c41-dffc-42dd-98ef-006d6d123341)",2022-03-11 13:46:36,2022-03-11 13:46:36
"50d0666c-3062-41a2-9bd0-b3be73620c10",9,46,-37,0.0526315789473684,36,23,59,"Positive","Demonstrationer landet over: Ann-Sophie vil tænde 330 gravlys mod udflytningskrav (50d0666c-3062-41a2-9bd0-b3be73620c10)",2022-01-12 15:00:14,2022-01-12 15:00:14
"518d4a44-200f-4c99-a4f9-c8995e494e23",48,71,-23,0.266666666666667,41,16,57,"Positive","Kæmpe sundhedsmæssig udfordring: Over halvdelen af fynboerne dyrker ikke nok motion (518d4a44-200f-4c99-a4f9-c8995e494e23)",2022-03-14 20:31:06,2022-03-14 20:31:06
"51d0fcfb-ba06-487e-8693-ae4b18f30f2a",32,45,-13,0.242424242424242,27,11,38,"Positive","Mads fra Gelsted hyldet: Dronning Margrethe hædrer fynsk garder med særligt kongeligt ur (51d0fcfb-ba06-487e-8693-ae4b18f30f2a)",2022-03-16 15:35:05,2022-03-16 15:35:05
"522b90ee-1314-42a1-8302-74215ba22a69",57,68,-11,0.41304347826087,37,7,44,"Positive","Genåbning efter corona: - Folk skal lige vænne sig til at komme ud igen (522b90ee-1314-42a1-8302-74215ba22a69)",2022-01-16 16:42:54,2022-01-16 16:42:54
"528e5dd4-50a2-4c4d-bd74-2aa5c8515658",-47,45,-92,-0.22488038277512,37,46,83,"Negative","Alvorligt byggesjusk: Rapport viser fare for stød og brand hos lejere i ombygget rådhus (528e5dd4-50a2-4c4d-bd74-2aa5c8515658)",2022-01-24 15:34:53,2022-01-24 15:34:53
"529f9e3d-dc51-41f7-b5fa-014424186a56",11,18,-7,0.127906976744186,11,6,17,"Positive","Populært som aldrig før: Jørgen flyttede i bofællesskab - det vil Jette også (529f9e3d-dc51-41f7-b5fa-014424186a56)",2022-03-16 13:17:33,2022-03-16 13:17:33
"531b5123-bb20-49b3-b655-df8e0c6f470e",22,52,-30,0.129411764705882,41,21,62,"Positive","Fire milliarder til mere biogas: Kunder kan ikke få hjælp til gasregningen (531b5123-bb20-49b3-b655-df8e0c6f470e)",2022-03-09 19:51:52,2022-03-09 19:51:52
"537ec389-2700-4cc9-aaf6-4c9ab69ccb0f",53,74,-21,0.370629370629371,36,15,51,"Positive","Se sammenligningen: Derfor er Axelsen i hælene på danske legender (537ec389-2700-4cc9-aaf6-4c9ab69ccb0f)",2022-03-21 12:55:36,2022-03-21 12:55:36
"5388cf5d-96c8-4b5c-a49e-08af45519020",-15,36,-51,-0.0815217391304348,29,33,62,"Negative","Manglen på arbejdskraft i dansk industri når nye højder (5388cf5d-96c8-4b5c-a49e-08af45519020)",2022-01-28 19:34:49,2022-01-28 19:34:49
"53e30713-8529-46d6-a3ef-070c0d4a64f1",5,36,-31,0.0359712230215827,29,19,48,"Positive","Billetter stadig til salg: Russiske ballerinaer optræder i Odense (53e30713-8529-46d6-a3ef-070c0d4a64f1)",2022-02-26 09:43:26,2022-02-26 09:43:26
"545409bd-f814-4c49-afbc-22ff6b5c4d7d",-70,61,-131,-0.236486486486486,44,69,113,"Negative","Hemmelige dokumenter afslører: Sexkrænkelser har stået på i årevis i Nyborg (545409bd-f814-4c49-afbc-22ff6b5c4d7d)",2022-02-24 19:32:45,2022-02-24 19:32:45
"5464c270-82e7-4888-bedb-1168aea79e6f",46,105,-59,0.160839160839161,80,31,111,"Positive","Risiko for oversvømmelser? I Lohals har de sikret sig mod stormflod (5464c270-82e7-4888-bedb-1168aea79e6f)",2022-01-14 15:52:14,2022-01-14 15:52:14
"5496f1e5-45f8-4953-b23a-8be22ef58496",-3,36,-39,-0.0272727272727273,31,23,54,"Negative","Invasion af Ukraine koster dyrt for fynske landmænd - og forbrugerne (5496f1e5-45f8-4953-b23a-8be22ef58496)",2022-03-01 14:38:10,2022-03-01 14:38:10
"55417eb0-1747-4ec7-9516-b7aa4a353839",-8,62,-70,-0.05,45,38,83,"Negative","Børns Vilkår: Sådan kan du tale med dit barn om krigen i Ukraine (55417eb0-1747-4ec7-9516-b7aa4a353839)",2022-02-24 21:03:21,2022-02-24 21:03:21
"55472707-0648-4619-81f8-91832da667fd",21,45,-24,0.12,34,17,51,"Positive","Se kortet: Her kan du hjælpe Ukraine (55472707-0648-4619-81f8-91832da667fd)",2022-03-01 17:01:15,2022-03-01 17:01:15
"55546bbf-17ee-4374-9659-61a41d07a5cc",-12,9,-21,-0.153846153846154,7,10,17,"Negative","Forsvundet 81-årig fundet død (55546bbf-17ee-4374-9659-61a41d07a5cc)",2022-02-21 21:32:12,2022-02-21 21:32:12
"5567e76a-a12f-470e-9ed8-6c63aaf33062",5,39,-34,0.0182481751824818,31,25,56,"Positive","Rådmand talte usandt: - Ingen jurister i kommunen har vurderet højspændingssagen (5567e76a-a12f-470e-9ed8-6c63aaf33062)",2022-03-01 17:47:52,2022-03-01 17:47:52
"556b3a02-5191-4d12-96af-c011dd0c8485",8,16,-8,0.102564102564103,11,7,18,"Positive","Kraftig blæst kan give forhøjet vandstand flere steder på Fyn (556b3a02-5191-4d12-96af-c011dd0c8485)",2022-01-16 07:16:17,2022-01-16 07:16:17
"55b35a99-ea93-4ae3-8acb-4af582a4f180",-2,4,-6,-0.0350877192982456,2,5,7,"Negative","Nu er de på vej: Bussen med flygtninge er nu kørt fra Krakow (55b35a99-ea93-4ae3-8acb-4af582a4f180)",2022-03-03 12:10:53,2022-03-03 12:10:53
"55ce3b57-7127-4dc6-b216-9fa600cb5a6b",-2,20,-22,-0.016,17,15,32,"Negative","Bonnesen med klar besked til fiskeriministeren: Hænderne op af lommen og kom i gang (55ce3b57-7127-4dc6-b216-9fa600cb5a6b)",2022-02-22 06:57:33,2022-02-22 06:57:33
"561fa6d8-9554-439d-8946-9edf04dbed75",-1,30,-31,-0.00775193798449612,24,21,45,"Negative","Kæmpe frafald: Næsten hver anden erhvervsskole-elev dropper ud (561fa6d8-9554-439d-8946-9edf04dbed75)",2022-03-02 18:30:12,2022-03-02 18:30:12
"566263d7-8c75-4808-a5db-7d0dd6b9147a",3,15,-12,0.0315789473684211,12,9,21,"Positive","Eriksens landsholdscomeback forsinkes af coronasmitte (566263d7-8c75-4808-a5db-7d0dd6b9147a)",2022-03-20 13:15:38,2022-03-20 13:15:38
"567a2904-dbd0-491b-8ed8-1f14e689c440",22,57,-35,0.123595505617978,35,21,56,"Positive","På Svendborg Sygehus er der plads til demente: Nu skal andre lære af dem (567a2904-dbd0-491b-8ed8-1f14e689c440)",2022-01-23 12:26:35,2022-01-23 12:26:35
"56abb921-8641-4957-a289-223e898789be",4,8,-4,0.133333333333333,5,4,9,"Positive","Lysshow, is-skulpturer og dinosaurer: Her er ti fynske vinterferieoplevelser (56abb921-8641-4957-a289-223e898789be)",2022-02-12 08:00:15,2022-02-12 08:00:15
"56d5c89a-07dd-4cd6-a256-3104d192ab28",-3,7,-10,-0.0681818181818182,4,6,10,"Negative","Tyv forsøgte at stjæle dagens omsætning med en kniv - et kvarter senere blev han anholdt (56d5c89a-07dd-4cd6-a256-3104d192ab28)",2022-01-26 20:45:40,2022-01-26 20:45:40
"56e10779-eb4b-44a2-8c83-78c8befce2db",-8,4,-12,-0.131147540983607,3,7,10,"Negative","Kvinde skubbet ud på kørebanen - politiet efterlyser undvigende bil (56e10779-eb4b-44a2-8c83-78c8befce2db)",2022-01-11 08:54:13,2022-01-11 08:54:13
"56f57cf4-39db-44d7-9fcc-201842b378ab",-17,10,-27,-0.141666666666667,9,16,25,"Negative","Stormen Nora kommer i aften: Sådan rammer ""hun"" din kommune (56f57cf4-39db-44d7-9fcc-201842b378ab)",2022-02-18 07:23:25,2022-02-18 07:23:25
"57221f37-edd5-472a-86e3-6c9d82ca887d",23,34,-11,0.186991869918699,18,10,28,"Positive","Lars Høgh-legendetrøje er til salg: OB spiller hyldestkamp i helt særlig målmandstrøje (57221f37-edd5-472a-86e3-6c9d82ca887d)",2022-02-22 12:56:12,2022-02-22 12:56:12
"576f58a2-bee6-4213-9137-566dd6241668",-17,42,-59,-0.096045197740113,35,41,76,"Negative","Stadig risiko for fejlmedicinering og manglende patientsikkerhed efter et halvt år (576f58a2-bee6-4213-9137-566dd6241668)",2022-01-21 09:20:33,2022-01-21 09:20:33
"577f1f67-c6ed-44b0-913b-38f509a4fd81",-1,10,-11,-0.0144927536231884,9,7,16,"Negative","Dræbt 22-årig vil blive mindet i Odense (577f1f67-c6ed-44b0-913b-38f509a4fd81)",2022-02-13 07:55:16,2022-02-13 07:55:16
"57f0a69f-b287-4904-bdec-caa411ae69e6",-4,18,-22,-0.0645161290322581,11,14,25,"Negative","To år senere: Fagfolk mener at nedlukning var rigtig (57f0a69f-b287-4904-bdec-caa411ae69e6)",2022-03-11 08:39:16,2022-03-11 08:39:16
"58263622-128c-4342-b6a2-9b86dde5e66f",33,58,-25,0.196428571428571,32,18,50,"Positive","Odense Håndbold fortsætter sejrskurs mod Viborg (58263622-128c-4342-b6a2-9b86dde5e66f)",2022-02-23 20:18:49,2022-02-23 20:18:49
"588c1d3b-f442-464f-acdf-ee8e237ce8bb",2,6,-4,0.0606060606060606,4,3,7,"Positive","Vejret: Endnu en kølig dag i vente (588c1d3b-f442-464f-acdf-ee8e237ce8bb)",2022-02-09 06:00:12,2022-02-09 06:00:12
"58a8dec8-c8c1-4166-b4c6-0720c619beb4",13,29,-16,0.119266055045872,20,13,33,"Positive","Nationale coronatal: Laveste antal siden januar bekræftet smittet med covid (58a8dec8-c8c1-4166-b4c6-0720c619beb4)",2022-02-20 14:18:40,2022-02-20 14:18:40
"58bdf03b-c9ab-4b81-9da8-656c2eb62494",-60,86,-146,-0.150375939849624,66,79,145,"Negative","Svindeljagt afslører hælerlager på Nordfyn: - Jeg har ikke gjort noget ulovligt (58bdf03b-c9ab-4b81-9da8-656c2eb62494)",2022-01-29 12:38:51,2022-01-29 12:38:51
"58c9938b-e748-4133-b19e-9b5b8dc68d78",-9,44,-53,-0.0486486486486487,34,32,66,"Negative","Mistede kæreste: Pårørende melder DB Cargo til politiet efter nærulykke (58c9938b-e748-4133-b19e-9b5b8dc68d78)",2022-01-26 19:15:09,2022-01-26 19:15:09
"58cf8dfe-26b6-4e57-8dbb-b49028901f30",17,47,-30,0.07981220657277,29,19,48,"Positive","Ministerrokade: Trine Bramsen ny transportminister (58cf8dfe-26b6-4e57-8dbb-b49028901f30)",2022-02-04 09:38:37,2022-02-04 09:38:37
"591c883e-fcf0-46e4-9133-d171ca3ae4bd",22,23,-1,0.338461538461538,12,1,13,"Positive","Viktor Axelsen kåret til Årets Fynske Sportsnavn (591c883e-fcf0-46e4-9133-d171ca3ae4bd)",2022-03-12 15:31:02,2022-03-12 15:31:02
"59338ccf-eac3-4075-bf7a-77d07aef3a79",-9,10,-19,-0.104651162790698,8,14,22,"Negative","Søndagens coronatal: Over syv dage når Fyn over 20.000 smittede (59338ccf-eac3-4075-bf7a-77d07aef3a79)",2022-01-23 14:02:11,2022-01-23 14:02:11
"5a01cf7f-02fa-4785-90b0-530857f7dace",26,38,-12,0.254901960784314,23,10,33,"Positive","Efter mere end 13 timer i bus: Flygtninge ankommer til Oure Friskole (5a01cf7f-02fa-4785-90b0-530857f7dace)",2022-03-03 19:24:55,2022-03-03 19:24:55
"5a2c89b0-0d78-494f-8dc9-d19728f064fb",10,41,-31,0.0689655172413793,32,28,60,"Positive","Afhængig af gas fra Rusland: Disse fynske virksomheder risikerer at stå uden gas (5a2c89b0-0d78-494f-8dc9-d19728f064fb)",2022-03-05 11:20:25,2022-03-05 11:20:25
"5a30c93a-f2f5-4637-be41-b2a242ca8310",18,22,-4,0.15929203539823,15,4,19,"Positive","Borgerforslag om gratis Storebæltsbro runder 50.000 underskrifter (5a30c93a-f2f5-4637-be41-b2a242ca8310)",2022-02-21 08:02:45,2022-02-21 08:02:45
"5a35b877-861c-4da3-922a-43ef954fe114",-7,24,-31,-0.0507246376811594,18,17,35,"Negative","Jens Henrik Thulesen Dahl får plads i DF's ledelse (5a35b877-861c-4da3-922a-43ef954fe114)",2022-02-24 18:18:07,2022-02-24 18:18:07
"5a4899a5-c35b-4634-9d5b-7239f4a025a4",-15,55,-70,-0.0857142857142857,45,40,85,"Negative","Efter langvarige rygter: Nu skal foreningen Søstre mod vold og kontrol undersøges (5a4899a5-c35b-4634-9d5b-7239f4a025a4)",2022-01-25 12:43:42,2022-01-25 12:43:42
"5a7e6c80-30c6-49ab-8352-ed9a80f0bbf4",15,27,-12,0.164835164835165,12,10,22,"Positive","Flere fynboer springer i faldskærm: - Folk keder sig (5a7e6c80-30c6-49ab-8352-ed9a80f0bbf4)",2022-02-13 11:57:14,2022-02-13 11:57:14
"5a8dfe8b-89f2-4949-aa41-f6e130fcfd4c",31,40,-9,0.24031007751938,24,7,31,"Positive","Officielt: Her er Christian Eriksens nye klub (5a8dfe8b-89f2-4949-aa41-f6e130fcfd4c)",2022-01-31 08:05:59,2022-01-31 08:05:59
"5a90636a-0662-4e37-8cc7-d4cdff59b881",11,29,-18,0.0846153846153846,18,16,34,"Positive","Nu skal skraldebiler køre på skrald i fynsk kommune (5a90636a-0662-4e37-8cc7-d4cdff59b881)",2022-02-28 20:13:18,2022-02-28 20:13:18
"5af6c698-1791-462a-9c7f-c97bc15ee6dc",35,46,-11,0.289256198347107,30,6,36,"Positive","Fynsk reservedels-gigant flytter til Assens (5af6c698-1791-462a-9c7f-c97bc15ee6dc)",2022-02-21 13:17:35,2022-02-21 13:17:35
"5af79d82-817e-47a4-ab82-ada9204a8281",17,34,-17,0.157407407407407,19,10,29,"Positive","Præst om homoseksuelle vielser: Hvis deres egen præst ikke vil, så må de komme til mig (5af79d82-817e-47a4-ab82-ada9204a8281)",2022-02-08 11:30:04,2022-02-08 11:30:04
"5b9bd2b4-0f2d-4cf2-a537-f0d759f3760f",-15,43,-58,-0.077720207253886,34,37,71,"Negative","Krigens regler overtrædes: Angreb på civile i Ukraine bliver dokumenteret i stor stil (5b9bd2b4-0f2d-4cf2-a537-f0d759f3760f)",2022-03-10 19:40:09,2022-03-10 19:40:09
"5c19eecd-fcc3-4ddb-b529-79783c39b589",-9,15,-24,-0.128571428571429,9,20,29,"Negative","Søndagens coronatal: Over 11.000 smittede fynboer på en uge (5c19eecd-fcc3-4ddb-b529-79783c39b589)",2022-01-16 14:35:39,2022-01-16 14:35:39
"5c763b7e-8c25-402e-8581-8e5ac798a289",-10,16,-26,-0.0980392156862745,13,18,31,"Negative","DMI lover tørvejr og måneskin til støttekoncert for Ukraine (5c763b7e-8c25-402e-8581-8e5ac798a289)",2022-03-11 05:39:18,2022-03-11 05:39:18
"5c9c2558-44d6-44d1-a0ec-d47bcd314b2b",32,57,-25,0.226950354609929,32,19,51,"Positive","Smuk Eriksen-assist sikrer vigtig sejr i uskønt bundgys (5c9c2558-44d6-44d1-a0ec-d47bcd314b2b)",2022-03-12 17:16:54,2022-03-12 17:16:54
"5cfa10bf-f62d-4335-8422-38b0f1e71782",42,70,-28,0.251497005988024,42,22,64,"Positive","Efter 21 år står profil med svært valg - ekspert har klar opfordring (5cfa10bf-f62d-4335-8422-38b0f1e71782)",2022-02-03 18:43:21,2022-02-03 18:43:21
"5d2b55cf-bb3d-42ec-9460-ee07ce8cf9f9",20,36,-16,0.169491525423729,29,9,38,"Positive","Egeskov Slot klar til at ansætte ukrainske flygtninge: - Vi tager imod med åbne arme (5d2b55cf-bb3d-42ec-9460-ee07ce8cf9f9)",2022-03-16 17:42:09,2022-03-16 17:42:09
"5d3efd7c-7f0d-4c1a-9872-9f3fdfcaf7e9",13,35,-22,0.0884353741496599,22,16,38,"Positive","Historisk julemarked står over for ""væsentlige forandringer"" (5d3efd7c-7f0d-4c1a-9872-9f3fdfcaf7e9)",2022-02-09 16:50:15,2022-02-09 16:50:15
"5da50df2-1830-416a-9238-dc24a4318466",29,38,-9,0.223076923076923,28,7,35,"Positive","Se videoen: 13-årige Patrick er verdens stærkeste (5da50df2-1830-416a-9238-dc24a4318466)",2022-02-22 05:56:03,2022-02-22 05:56:03
"5ddb39bc-3df2-45e5-9f8e-4843bb5beedd",-11,2,-13,-0.215686274509804,1,10,11,"Negative","Først regn og slud - men så kommer solen (5ddb39bc-3df2-45e5-9f8e-4843bb5beedd)",2022-02-11 05:54:50,2022-02-11 05:54:50
"5ddbb748-521a-45c5-9c40-f14ade270485",2,13,-11,0.0327868852459016,7,8,15,"Positive","Kold start på dagen giver risiko for glatte veje (5ddbb748-521a-45c5-9c40-f14ade270485)",2022-01-15 06:37:56,2022-01-15 06:37:56
"5ddfefdd-a448-4708-b772-d0a9f237bb7f",-6,15,-21,-0.0810810810810811,8,11,19,"Negative","Travl nat for politiet: Spritbilist stak af fra uheld - men øjenvidne fulgte efter (5ddfefdd-a448-4708-b772-d0a9f237bb7f)",2022-03-20 10:20:12,2022-03-20 10:20:12
"5e5bfe28-c283-4c88-b001-124970d898de",25,49,-24,0.173611111111111,31,16,47,"Positive","Tæt på 100.000 indsamlet: Forfattere støtter ofre for krigen med boglotteri (5e5bfe28-c283-4c88-b001-124970d898de)",2022-03-21 07:08:17,2022-03-21 07:08:17
"5eb25a26-6b23-44bb-a04e-0b517ea7c475",-19,11,-30,-0.131034482758621,10,22,32,"Negative","Se ventetiderne på OUH: Patienter kan vente i op til 58 uger på undersøgelse (5eb25a26-6b23-44bb-a04e-0b517ea7c475)",2022-02-11 09:23:29,2022-02-11 09:23:29
"5f460ddc-773b-45d8-8b6c-e98e9fca194a",9,26,-17,0.09,15,14,29,"Positive","Småt brændbart er skrottet: - Man skal gøre det for klimaet, ikke økonomien (5f460ddc-773b-45d8-8b6c-e98e9fca194a)",2022-02-16 07:59:16,2022-02-16 07:59:16
"5f883599-430b-4bee-8455-3c11cd241d99",31,41,-10,0.36046511627907,25,5,30,"Positive","Banker har fortsat vinden i ryggen: Rigtig pæn vækst i Fynske Bank (5f883599-430b-4bee-8455-3c11cd241d99)",2022-03-04 11:38:11,2022-03-04 11:38:11
"5fc62669-861d-446d-9b1d-1915807ed1e2",-14,6,-20,-0.205882352941176,5,13,18,"Negative","Person fundet omkommet efter voldsom gårdbrand på Vestfyn (5fc62669-861d-446d-9b1d-1915807ed1e2)",2022-03-20 09:31:00,2022-03-20 08:16:51
"5aa0102c-b2d3-4805-ba65-df13dde27f90",12,46,-34,0.0745341614906832,32,20,52,"Positive","Borgmester er rystet: - Det er jo helt vanvittigt, at vi skal bringes i sådan en situation (5aa0102c-b2d3-4805-ba65-df13dde27f90)",2022-02-08 16:56:24,2022-02-08 16:56:24
"6052ec03-5191-4a46-84a8-f83f86f91140",19,32,-13,0.182692307692308,23,8,31,"Positive","Høghs efterladte kritiserer OB for at tjene på hyldesttrøje (6052ec03-5191-4a46-84a8-f83f86f91140)",2022-02-15 18:01:31,2022-02-15 18:01:31
"605db1ed-af02-4b1d-9794-24c5e4235373",21,80,-59,0.105527638190955,51,34,85,"Positive","Oprør på OUH: - Vi kan ikke både lave mad, køre patienter og gøre rent på samme tid (605db1ed-af02-4b1d-9794-24c5e4235373)",2022-01-21 15:55:13,2022-01-21 15:55:13
"6153bed5-bee4-427f-904a-2f46582bcb41",4,41,-37,0.0287769784172662,21,27,48,"Positive","GOG kvaser sagesløse finske Cocks i ensidig forestilling (6153bed5-bee4-427f-904a-2f46582bcb41)",2022-02-22 19:34:32,2022-02-22 19:34:32
"619ecfee-f865-46cc-b70f-4d9c1efe57d3",1,19,-18,0.00869565217391304,14,13,27,"Positive","Fire ud af fem daginstitutioner ramt af corona den seneste uge (619ecfee-f865-46cc-b70f-4d9c1efe57d3)",2022-01-13 20:41:49,2022-01-13 20:41:49
"61cb1d03-d465-49bc-9c0f-c5409271416e",22,29,-7,0.224489795918367,24,5,29,"Positive","Fjernvarme Fyn: Det skal blive grønnere, men ikke dyrere (61cb1d03-d465-49bc-9c0f-c5409271416e)",2022-01-17 21:12:32,2022-01-17 21:12:32
"61cd21a6-5ea9-4dc8-821a-aaa0d153d72d",9,71,-62,0.0319148936170213,50,39,89,"Positive","29-årige Mads frygter at blive den sidste fisker i historisk fiskeriby (61cd21a6-5ea9-4dc8-821a-aaa0d153d72d)",2022-02-18 13:50:07,2022-02-18 13:50:07
"61ce0c13-8193-4ef0-8fd7-71fc06e306d4",-5,18,-23,-0.033112582781457,14,14,28,"Negative","Stormen rammer tog- og færgedrift på Fyn (61ce0c13-8193-4ef0-8fd7-71fc06e306d4)",2022-01-29 09:45:00,2022-01-28 21:07:02
"61d1d9a0-7349-441d-bbb2-62a4c79af582",21,97,-76,0.0614035087719298,74,42,116,"Positive","Politisk pres for dansk enegang mod russisk olieeksport (61d1d9a0-7349-441d-bbb2-62a4c79af582)",2022-03-18 09:30:00,2022-03-18 09:30:00
"62093aa9-9c53-4f65-950d-92715fea7e1e",3,28,-25,0.0254237288135593,23,19,42,"Positive","Trods verdensomspændende sanktioner: Russisk skib i Assens sender træpiller ud til fynboer (62093aa9-9c53-4f65-950d-92715fea7e1e)",2022-03-09 10:50:40,2022-03-09 10:50:40
"625a0c5c-d160-4bf1-a13e-5363080a6277",14,32,-18,0.144329896907216,23,13,36,"Positive","Onsdagens coronatal: Smitten falder på Fyn (625a0c5c-d160-4bf1-a13e-5363080a6277)",2022-02-02 13:33:29,2022-02-02 13:33:29
"631d6e42-d73d-4286-b70e-54ae399cd9f1",-18,24,-42,-0.230769230769231,19,26,45,"Negative","Zoo kommer med advarsel til gæsterne: - Man kan tydeligt se, dyrene har ondt (631d6e42-d73d-4286-b70e-54ae399cd9f1)",2022-02-12 11:51:04,2022-02-12 11:51:04
"635675f7-882a-46c2-b4b9-0c5d4659c3b0",17,47,-30,0.123188405797101,32,16,48,"Positive","Behovet er stigende: Odense vil lave nyt tilbud til mennesker med senfølger efter covid-19 (635675f7-882a-46c2-b4b9-0c5d4659c3b0)",2022-01-19 12:49:05,2022-01-19 12:49:05
"63f7db9c-830c-4a99-80ad-f5424ed08e4e",-3,7,-10,-0.06,3,8,11,"Negative","Teenager sneg sig over Storebæltsbroen uden at betale (63f7db9c-830c-4a99-80ad-f5424ed08e4e)",2022-01-18 09:19:58,2022-01-18 09:19:58
"6428b6de-2538-4cc0-9b2d-d07b8dfd1bc3",-34,4,-38,-0.386363636363636,4,16,20,"Negative","Tre røverier på under en uge: Fyns Politi efterforsker mulig sammenhæng (6428b6de-2538-4cc0-9b2d-d07b8dfd1bc3)",2022-02-12 11:22:50,2022-02-12 11:22:50
"646830fc-d3ae-4f6d-9c10-74f8f7b36f80",4,48,-44,0.0258064516129032,40,27,67,"Positive","En professor vurderer: Vi kan tage meget med os fra 676 dage med corona (646830fc-d3ae-4f6d-9c10-74f8f7b36f80)",2022-01-16 18:54:15,2022-01-16 18:54:15
"64b039cc-9de3-4934-acb8-6e7e771cb87e",-1,38,-39,-0.00561797752808989,30,30,60,"Negative","Frygt før storm: Kommune spærrer vej af ved nedlagt fabrik (64b039cc-9de3-4934-acb8-6e7e771cb87e)",2022-02-18 17:21:45,2022-02-18 17:21:45
"64e878a7-2d56-4dd8-b06d-2477b19eeb4c",21,53,-32,0.154411764705882,39,24,63,"Positive","Kæledyr ramt af krigen: Agata fragter hundefoder og nødhjælp til Ukraine (64e878a7-2d56-4dd8-b06d-2477b19eeb4c)",2022-03-06 19:10:36,2022-03-06 19:10:36
"652dc24c-ac2d-4ac4-8a3b-8c4bcf2dae97",25,48,-23,0.178571428571429,35,14,49,"Positive","Fynboer vil hjælpe Ukraine: 29-årige Ida vil i Hjemmeværnet (652dc24c-ac2d-4ac4-8a3b-8c4bcf2dae97)",2022-03-07 17:41:33,2022-03-07 17:41:33
"6591b02e-c066-4aca-9afb-4abbf2576f02",24,30,-6,0.247422680412371,21,3,24,"Positive","Ukrainere får også adgang til integrationsuddannelse (6591b02e-c066-4aca-9afb-4abbf2576f02)",2022-03-13 07:57:47,2022-03-13 07:57:47
"65b384c1-fe95-4c25-a38b-0c67f414bc06",-16,47,-63,-0.0888888888888889,36,38,74,"Negative","Styrelse retter kritik: Plejecenter får påbud for dårlig demenspleje og mangelfuld dokumentation (65b384c1-fe95-4c25-a38b-0c67f414bc06)",2022-02-06 18:01:45,2022-02-06 18:01:45
"65c597b5-4ed0-4783-9152-b8e8ad1d7362",-1,12,-13,-0.0125,8,8,16,"Negative","Fynsk polak kører ambulance til Ukraine: De mangler alt (65c597b5-4ed0-4783-9152-b8e8ad1d7362)",2022-03-12 06:17:07,2022-03-12 06:17:07
"663cf43f-8ae6-4988-b132-753aa7e07d6b",2,9,-7,0.0327868852459016,9,7,16,"Positive","1000 ukrainere har søgt asyl i Danmark (663cf43f-8ae6-4988-b132-753aa7e07d6b)",2022-03-12 09:22:38,2022-03-12 09:22:38
"669b470b-20dd-466b-8465-abcd917649e6",41,85,-44,0.231638418079096,57,24,81,"Positive","Akut hjælp: Kampen mod negativ social kontrol skal styrkes i Odense (669b470b-20dd-466b-8465-abcd917649e6)",2022-02-01 10:35:47,2022-02-01 10:35:47
"6715ed2c-f0cb-433b-80b9-93594fddf844",21,81,-60,0.114130434782609,49,38,87,"Positive","Nervøse gaskunder bestormer Energi Fyn: - Det er en del af en glædelig udvikling (6715ed2c-f0cb-433b-80b9-93594fddf844)",2022-03-16 12:04:14,2022-03-16 12:04:14
"67991730-b247-4ac5-ae40-c269aed925e9",11,20,-9,0.10377358490566,12,7,19,"Positive","Fynsk socialdemokrat blev ved en fejl indkaldt som vikar i Folketinget (67991730-b247-4ac5-ae40-c269aed925e9)",2022-01-19 14:15:57,2022-01-19 14:15:57
"67d0be02-fcec-4048-979e-78f2a46cbe91",1,15,-14,0.0106382978723404,10,11,21,"Positive","TV 2 erfarer: Her er indstillingerne fra Epidemikommissionen (67d0be02-fcec-4048-979e-78f2a46cbe91)",2022-01-25 12:55:28,2022-01-25 12:55:28
"68ad3d55-0844-4408-b623-ba9600268a7a",22,52,-30,0.109452736318408,35,19,54,"Positive","Landmand fra Lyø fik nej til realkreditlån: Håber nu på finansiering fra private (68ad3d55-0844-4408-b623-ba9600268a7a)",2022-01-31 14:42:38,2022-01-31 14:42:38
"68c61a20-ff76-4733-8223-5952fa33a662",11,31,-20,0.0916666666666667,20,13,33,"Positive","Hotline skal give krisehjælp til ukrainere på Fyn (68c61a20-ff76-4733-8223-5952fa33a662)",2022-03-01 11:17:53,2022-03-01 11:17:53
"68c927bf-68a3-44d2-8bf8-7fa95b9554cc",11,13,-2,0.1375,11,2,13,"Positive","Grønne ambitioner på Fyn skaber flere nye job (68c927bf-68a3-44d2-8bf8-7fa95b9554cc)",2022-03-17 11:18:29,2022-03-17 11:18:29
"68e1fd2c-16f7-4db0-8d2d-6ac2e7feb566",11,42,-31,0.0674846625766871,30,24,54,"Positive","Vil have nye regler for elløbehjul: - Jeg er træt af, at de ligger hulter til bulter (68e1fd2c-16f7-4db0-8d2d-6ac2e7feb566)",2022-02-25 06:50:26,2022-02-25 06:50:26
"691b7418-93b3-4d39-9a60-1cd97500a593",-7,19,-26,-0.0636363636363636,17,14,31,"Negative","Klokkeklar sejr: Messerschmidt er ny formand for Dansk Folkeparti (691b7418-93b3-4d39-9a60-1cd97500a593)",2022-01-23 15:03:00,2022-01-23 14:38:12
"6937688a-d850-4be1-9983-0d870883c549",6,54,-48,0.0294117647058824,43,36,79,"Positive","Viktor Axelsen får bøde på 25.000 kroner (6937688a-d850-4be1-9983-0d870883c549)",2022-01-25 19:29:22,2022-01-25 19:29:22
"696c7710-8d22-4b3c-baa0-b43bf78bec22",-20,4,-24,-0.224719101123595,3,19,22,"Negative","Mandagens coronatal: Smittetallene sætter igen rekord på Fyn (696c7710-8d22-4b3c-baa0-b43bf78bec22)",2022-01-24 13:46:16,2022-01-24 13:46:16
"69850f4c-6cfa-4505-af58-377d819ee736",62,77,-15,0.433566433566434,57,15,72,"Positive","Mødrehjælpen efterspørger donationer: Har du konfirmationstøj hængende i skabet? (69850f4c-6cfa-4505-af58-377d819ee736)",2022-02-08 20:36:07,2022-02-08 20:36:07
"6a088cfc-46c9-4f9f-9e7f-69585d964077",-7,16,-23,-0.0752688172043011,13,16,29,"Negative","Baltic Pipe river skoleskov op med rødderne (6a088cfc-46c9-4f9f-9e7f-69585d964077)",2022-03-08 20:06:56,2022-03-08 20:06:56
"6a093a73-6864-4720-b2a0-67bb14606078",-8,9,-17,-0.10126582278481,7,11,18,"Negative","Ældre kvinde dræbt i stormen - blev trukket med af dør (6a093a73-6864-4720-b2a0-67bb14606078)",2022-01-30 11:35:43,2022-01-30 11:35:43
"6a4ec3aa-e4b2-416f-81d0-b354e3a6319d",-12,9,-21,-0.181818181818182,8,10,18,"Negative","Har nu meldt sig selv: Politiet efterlyste gerningsmand for vold mod dreng (6a4ec3aa-e4b2-416f-81d0-b354e3a6319d)",2022-03-03 09:58:50,2022-03-03 09:58:50
"6a5f3d7f-b83d-48b6-bc80-f52c996a5cdb",14,46,-32,0.074468085106383,30,18,48,"Positive","Politikere afviser at flytte højspændingskabel: - Beboerne må jo opsige deres lejemål og flytte (6a5f3d7f-b83d-48b6-bc80-f52c996a5cdb)",2022-02-23 15:17:13,2022-02-23 15:17:13
"6a680948-2552-400c-81b8-5875728576b2",-2,14,-16,-0.0169491525423729,12,12,24,"Negative","Dan Jørgensen og kollegaernes gode aften: Brugte over 15.000 kroner på vin og mad (6a680948-2552-400c-81b8-5875728576b2)",2022-02-09 12:48:12,2022-02-09 12:48:12
"6a860158-ce03-4acd-b51a-cf544f91b0e3",14,25,-11,0.181818181818182,15,6,21,"Positive","Mette og Dag hemmeligt gift: Afslører det på tv (6a860158-ce03-4acd-b51a-cf544f91b0e3)",2022-02-22 18:22:14,2022-02-22 18:22:14
"6b00daf9-a5ec-4d50-b2ff-f0256b6de5fc",26,27,-1,0.481481481481481,13,1,14,"Positive","Money, money, money: 20 fynboer er blevet lottomillionærer (6b00daf9-a5ec-4d50-b2ff-f0256b6de5fc)",2022-01-20 05:26:23,2022-01-20 05:26:23
"6b125693-f4ba-4de6-afb5-c7dec38c4c1e",15,16,-1,0.2,8,1,9,"Positive","Se kortet: Så mange fynboer er blevet viet 22.02.2022 (6b125693-f4ba-4de6-afb5-c7dec38c4c1e)",2022-02-22 17:18:04,2022-02-22 17:18:04
"6b164db1-f7e6-4b6d-a4c0-fa225e892b3d",-19,6,-25,-0.256756756756757,6,13,19,"Negative","Brud på hofte og bækken: Elev fra fynsk efterskole faldt mindst seks meter fra skilift (6b164db1-f7e6-4b6d-a4c0-fa225e892b3d)",2022-01-24 12:24:02,2022-01-24 12:24:02
"6b20cf17-3abb-4544-98a7-23a1a0aadeea",-40,29,-69,-0.216216216216216,18,41,59,"Negative","Friske tal om uheld på elløbehjul: Hver tredje skader hovedet, ansigtet eller tænderne (6b20cf17-3abb-4544-98a7-23a1a0aadeea)",2022-02-26 07:57:46,2022-02-26 07:57:46
"6b3bbe9c-9921-48a0-b9bc-883d62317c2b",32,55,-23,0.246153846153846,37,14,51,"Positive","Fynsk fakkeltog til ære for unge Mia og Oliver: - Det er en måde for os at vise, hvad vi føler (6b3bbe9c-9921-48a0-b9bc-883d62317c2b)",2022-02-13 19:07:17,2022-02-13 19:07:17
"6b6ae558-e9b2-41d8-a2d5-888a5e2f97c3",-20,15,-35,-0.229885057471264,10,18,28,"Negative","Ekstrem stormflod rammer nu Danmark (6b6ae558-e9b2-41d8-a2d5-888a5e2f97c3)",2022-01-30 08:29:56,2022-01-30 08:29:56
"6ba4e7fe-501d-4aac-a885-1bbb57e7c6a4",-13,12,-25,-0.12621359223301,8,16,24,"Negative","Stormen Nora snittede Fyn: Regnen skabte dog problemer (6ba4e7fe-501d-4aac-a885-1bbb57e7c6a4)",2022-02-20 13:46:05,2022-02-20 13:46:05
"6bcf33a1-461b-4b03-a525-0dfd56e6e8fd",11,43,-32,0.0733333333333333,30,18,48,"Positive","Gitte Andreasen fik et chok over sin gasregning: - Det gør mig gal og ked af det (6bcf33a1-461b-4b03-a525-0dfd56e6e8fd)",2022-03-08 18:08:14,2022-03-08 18:08:14
"6be11cde-79e3-4462-9b34-da1a6d009a7e",17,48,-31,0.10828025477707,34,25,59,"Positive","Erhvervsorganisationer: - På tide vi betragter corona som en almindelig influenza (6be11cde-79e3-4462-9b34-da1a6d009a7e)",2022-01-18 10:14:14,2022-01-18 10:14:14
"6c0b64bf-85d9-4e8a-9bae-50c8f17ef796",-4,28,-32,-0.0310077519379845,17,19,36,"Negative","Freja og Rosa drømmer om at blive sygeplejersker - men fremtiden skræmmer (6c0b64bf-85d9-4e8a-9bae-50c8f17ef796)",2022-03-17 05:03:07,2022-03-17 05:03:07
"6cc89f3c-6352-4039-85a0-2a36ef64eb5e",8,17,-9,0.0792079207920792,11,6,17,"Positive","Efterlyst 13-årig pige og 18-årig mand: De befinder sig formentlig i Sverige, oplyser Fyns Politi (6cc89f3c-6352-4039-85a0-2a36ef64eb5e)",2022-02-20 10:27:35,2022-02-20 10:27:35
"6d0d0889-53c5-4eac-8747-be493097ddcb",66,78,-12,0.434210526315789,52,7,59,"Positive","OUH opfordrer patienter at gå til privathospitaler, men de vil hellere vente (6d0d0889-53c5-4eac-8747-be493097ddcb)",2022-01-21 19:24:36,2022-01-21 19:24:36
"6d17b4e4-c910-4ee5-9b45-95b72288d535",13,47,-34,0.0734463276836158,38,20,58,"Positive","Nu skal det være slut med at bo ulovligt i kolonihaver i Odense (6d17b4e4-c910-4ee5-9b45-95b72288d535)",2022-01-24 17:56:22,2022-01-24 17:56:22
"6d17ec2c-50f0-4309-9aff-6ebc1851008e",-17,29,-46,-0.100591715976331,22,25,47,"Negative","Flere steder kan vand true over 100 gange årligt i fremtiden (6d17ec2c-50f0-4309-9aff-6ebc1851008e)",2022-01-10 07:23:39,2022-01-10 07:23:39
"6d204bf3-07eb-472e-9b78-b6c126daad58",50,84,-34,0.381679389312977,47,25,72,"Positive","Odense-keeper: Virkelig rodet og uskøn kamp mod CSKA (6d204bf3-07eb-472e-9b78-b6c126daad58)",2022-01-09 18:46:13,2022-01-09 18:46:13
"6d3685cd-e347-43f2-833a-029ef4d2689d",17,39,-22,0.153153153153153,25,14,39,"Positive","Tom bus afsted for at hente flygtninge: - Det føles helt fantastisk (6d3685cd-e347-43f2-833a-029ef4d2689d)",2022-03-01 20:18:27,2022-03-01 20:18:27
"6d4e8be0-51b3-4a3f-95dd-0b4dcf8d8b00",12,34,-22,0.094488188976378,29,15,44,"Positive","UCL mister stort antal studiepladser i Odense (6d4e8be0-51b3-4a3f-95dd-0b4dcf8d8b00)",2022-01-21 20:05:06,2022-01-21 20:05:06
"6d55d625-ec12-4bfe-8dde-d6699ed438f2",-2,0,-2,-0.105263157894737,0,1,1,"Negative","Sæt farten ned: Fyns Politi advarer om glatte veje fra morgenstunden (6d55d625-ec12-4bfe-8dde-d6699ed438f2)",2022-02-07 05:37:31,2022-02-07 05:37:31
"6d69ea75-8d7d-4405-92c0-35f8fa90d9b5",38,57,-19,0.273381294964029,41,13,54,"Positive","De unge læser for lidt: Nu sætter fynsk gymnasie koncentration, fordybelse og litteratur på skoleskemaet (6d69ea75-8d7d-4405-92c0-35f8fa90d9b5)",2022-01-25 08:38:42,2022-01-25 08:38:42
"6db5fc8f-c22d-483a-953c-8b40b081fbcd",-11,22,-33,-0.0733333333333333,16,18,34,"Negative","Danskerne skal stemme om forsvarsforbeholdet 1. juni (6db5fc8f-c22d-483a-953c-8b40b081fbcd)",2022-03-06 16:43:44,2022-03-06 16:43:44
"6dc6046d-52bf-48cc-88f8-4c22974f7ef6",-15,7,-22,-0.205479452054795,5,19,24,"Negative","To millioner smittede på landsplan: På Fyn stiger smitten en lille smule (6dc6046d-52bf-48cc-88f8-4c22974f7ef6)",2022-02-06 15:26:28,2022-02-06 15:26:28
"6dd94bc8-be8b-405d-998d-1c8a34790ece",-9,23,-32,-0.0841121495327103,13,14,27,"Negative","Gidsel om første slutrundekamp med fans: De hiver os op (6dd94bc8-be8b-405d-998d-1c8a34790ece)",2022-01-14 10:48:54,2022-01-14 10:48:54
"6e62b290-3c59-4ade-8058-f04c41dd0093",7,20,-13,0.07,16,9,25,"Positive","Odenseaner vil hjælpe flygtninge hjem - men kan ikke få lov (6e62b290-3c59-4ade-8058-f04c41dd0093)",2022-03-02 19:53:39,2022-03-02 19:53:39
"6e94ffb6-d5b1-44e7-9188-d919e3010b68",17,26,-9,0.160377358490566,18,8,26,"Positive","TV 2 Fyn på vej mod Ukraine: 40 ukrainske flygtninge skal med retur (6e94ffb6-d5b1-44e7-9188-d919e3010b68)",2022-03-02 08:44:10,2022-03-02 08:44:10
"6eba2a57-5257-467e-ba77-e2edbcce0450",7,28,-21,0.0457516339869281,21,15,36,"Positive","Læge fragter medicin til krigen: - Det er også vores krig det her (6eba2a57-5257-467e-ba77-e2edbcce0450)",2022-03-14 08:03:37,2022-03-14 08:03:37
"6ee9ec1d-7f59-49bb-afa3-4a8219226f20",-11,46,-57,-0.0495495495495495,31,33,64,"Negative","Psykisk syg blev kørt fra København til Rudkøbing: Langelands borgmester klager over politiet (6ee9ec1d-7f59-49bb-afa3-4a8219226f20)",2022-02-25 10:28:00,2022-02-24 17:39:27
"6f43a82d-79bd-440c-b945-1b0ddb9668b6",22,30,-8,0.136645962732919,21,7,28,"Positive","Huse, keramik og andre skatte: Arkæologer gør sig et overraskende fund (6f43a82d-79bd-440c-b945-1b0ddb9668b6)",2022-03-05 16:29:40,2022-03-05 16:29:40
"6fbd4132-c94c-4c04-b59b-103350d6327f",-12,61,-73,-0.0634920634920635,36,38,74,"Negative","Politiet deler billeder fra ulykke med højgravid kvinde til ""skræk og advarsel"" (6fbd4132-c94c-4c04-b59b-103350d6327f)",2022-01-27 14:09:03,2022-01-27 14:09:03
"7063be3c-8717-40c3-9ca0-a29844602c52",11,28,-17,0.0973451327433628,17,10,27,"Positive","OUH efterlyser fynboer: - Lige nu mangler vi cirka 1.000 bloddonorer (7063be3c-8717-40c3-9ca0-a29844602c52)",2022-03-17 19:23:31,2022-03-17 19:23:31
"707668da-cb95-4b37-8f56-6b658b458733",11,23,-12,0.119565217391304,18,6,24,"Positive","Sundhedsøkonom: Fokus på det nære lille skridt i rigtig retning (707668da-cb95-4b37-8f56-6b658b458733)",2022-03-16 05:05:09,2022-03-16 05:05:09
"70dd66d1-9355-49d8-ac83-a5fe75910a60",33,51,-18,0.185393258426966,34,14,48,"Positive","Gasprisen stiger 80 procent: Her er tre alternativer til russisk gas (70dd66d1-9355-49d8-ac83-a5fe75910a60)",2022-03-07 18:24:11,2022-03-07 18:24:11
"70fba0dd-a09c-4892-a579-815a54e2f12d",17,90,-73,0.0588235294117647,62,51,113,"Positive","En halv million danskere kan miste coronapas fra næste uge (70fba0dd-a09c-4892-a579-815a54e2f12d)",2022-01-12 05:31:29,2022-01-12 05:31:29
"71031aa3-3621-4139-a7bb-e22ea0541941",25,32,-7,0.217391304347826,23,5,28,"Positive","Christian Eriksen: - Jeg vil behandles som alle andre fodboldspillere (71031aa3-3621-4139-a7bb-e22ea0541941)",2022-02-11 17:27:36,2022-02-11 17:27:36
"7118dcb9-0b7f-45ca-b52d-1914995edea1",-14,15,-29,-0.152173913043478,11,15,26,"Negative","Butikker sætter vagter ind efter stribe af røverier: - Der skal en særlig situation til (7118dcb9-0b7f-45ca-b52d-1914995edea1)",2022-03-18 05:07:02,2022-03-18 05:07:02
"71353981-695f-4273-992d-6fd22a1eaf69",17,24,-7,0.25,15,4,19,"Positive","Se videoen: 27 skud affyret til ære for dronningen (71353981-695f-4273-992d-6fd22a1eaf69)",2022-01-14 16:34:02,2022-01-14 16:34:02
"71433ee0-2886-4eba-94db-b8a4b4c8f886",2,10,-8,0.0350877192982456,7,8,15,"Positive","Onsdagens coronatal: Smitten stiger over det meste af Fyn (71433ee0-2886-4eba-94db-b8a4b4c8f886)",2022-02-09 14:20:03,2022-02-09 14:20:03
"7182a973-dde4-45dc-9063-6a8a97f85b22",12,16,-4,0.169014084507042,13,3,16,"Positive","Se kortet: Så mange ukrainske flygtninge får din kommune (7182a973-dde4-45dc-9063-6a8a97f85b22)",2022-03-16 19:49:10,2022-03-16 19:49:10
"71ed965c-b5ea-410a-aa5c-fc07f35469c5",66,72,-6,0.423076923076923,47,5,52,"Positive","Johnny pynter Nyborg til årets største dag: - Hvem får i det hele taget lov til at lave noget for selveste Tour de France (71ed965c-b5ea-410a-aa5c-fc07f35469c5)",2022-03-19 18:50:33,2022-03-19 18:50:33
"727abd1e-bf7f-40e0-b054-a312078de773",14,21,-7,0.197183098591549,13,3,16,"Positive","Middelfarts kommunaldirektør stopper (727abd1e-bf7f-40e0-b054-a312078de773)",2022-02-08 12:41:45,2022-02-08 12:41:45
"7295353a-da7e-4fa8-8d0e-c2f36f074a25",4,17,-13,0.0412371134020619,10,8,18,"Positive","Brandenborg åben for ukrainske flygtninge på Holmegaard (7295353a-da7e-4fa8-8d0e-c2f36f074a25)",2022-02-25 17:23:04,2022-02-25 17:23:04
"72ac90b7-2335-4306-80ea-c91dfba30797",32,34,-2,0.316831683168317,25,2,27,"Positive","Krigen i Ukraine: Krisestab gør klar til håndtering af flygtninge på Sydfyn (72ac90b7-2335-4306-80ea-c91dfba30797)",2022-03-03 20:49:02,2022-03-03 20:49:02
"72ae2bfb-d495-4a32-b337-28f3b55e07c7",13,20,-7,0.139784946236559,15,6,21,"Positive","Eksperter tror coronapandemien vil brænde ud inden forår (72ae2bfb-d495-4a32-b337-28f3b55e07c7)",2022-01-11 05:13:09,2022-01-11 05:13:09
"72e8794d-1de2-4a64-a2f4-3fb278be9ab3",18,24,-6,0.346153846153846,15,3,18,"Positive","Stort overskud og flere kunder i Totalbanken (72e8794d-1de2-4a64-a2f4-3fb278be9ab3)",2022-02-26 16:14:11,2022-02-26 16:14:11
"73558c33-b22e-4bd9-bdae-ef86d1920abd",48,67,-19,0.263736263736264,41,14,55,"Positive","Fynske lokalformænd splittede efter personsag om dobbeltliv (73558c33-b22e-4bd9-bdae-ef86d1920abd)",2022-01-25 18:19:27,2022-01-25 18:19:27
"7382bda4-c718-4f2e-8201-3cc16ae98d56",-17,44,-61,-0.096045197740113,35,36,71,"Negative","Nedslidt udstyr og mangel på tandlæger: - Vi kan ikke give borgerne det tilbud, de har krav på (7382bda4-c718-4f2e-8201-3cc16ae98d56)",2022-03-05 08:01:33,2022-03-05 08:01:33
"73b2ae8c-65d6-4160-982a-5e12fa952d12",78,93,-15,0.516556291390728,64,11,75,"Positive","Flere fynske virksomheder er blevet mere bæredygtige: Men vi er langt fra mål, mener professor (73b2ae8c-65d6-4160-982a-5e12fa952d12)",2022-03-18 17:26:00,2022-03-18 17:26:00
"73f482d3-f487-4ff3-8c12-36ea58a038db",-24,20,-44,-0.237623762376238,16,26,42,"Negative","SDU-professor revser myndighederne i sag om giftige fluorstoffer: - Det bliver kun værre (73f482d3-f487-4ff3-8c12-36ea58a038db)",2022-01-29 10:47:29,2022-01-29 10:47:29
"74513e27-d1ed-405f-a050-c9627c73e9df",-5,10,-15,-0.0581395348837209,6,12,18,"Negative","Se coronatallene for dit sogn: Smitten falder i én kommune (74513e27-d1ed-405f-a050-c9627c73e9df)",2022-01-25 14:34:02,2022-01-25 14:34:02
"74a559cb-da1c-448e-84ac-80d781145f92",5,33,-28,0.0342465753424658,24,21,45,"Positive","10.000 år gammel fynbo får sit eget museum - men hvem var han? (74a559cb-da1c-448e-84ac-80d781145f92)",2022-01-11 18:45:08,2022-01-11 18:45:08
"74d5995e-b3b6-43e8-ae98-ffdc697d7ad9",45,53,-8,0.365853658536585,32,5,37,"Positive","Hylder Dronningen: H.C. Andersen festivalen bliver mere royal i 2023 (74d5995e-b3b6-43e8-ae98-ffdc697d7ad9)",2022-01-16 09:00:11,2022-01-16 09:00:11
"74fc7203-2a9c-4cb9-9b6e-57bf3316b576",9,47,-38,0.0789473684210526,28,24,52,"Positive","Frustreret OB-trænervikar: Vi laver en perlerække af fejl (74fc7203-2a9c-4cb9-9b6e-57bf3316b576)",2022-03-15 05:17:55,2022-03-15 05:17:55
"752c2108-4776-4771-9b35-176aa5a51a55",4,24,-20,0.0357142857142857,16,16,32,"Positive","Fynboerne får en tør og solrig start på mandagen (752c2108-4776-4771-9b35-176aa5a51a55)",2022-03-14 06:21:23,2022-03-14 06:21:23
"754d2b44-9d62-4fe0-8e19-f72d95bbaad8",11,30,-19,0.0866141732283465,20,10,30,"Positive","Konservative: Ukrainske flygtninge skal tilbydes arbejde med det samme (754d2b44-9d62-4fe0-8e19-f72d95bbaad8)",2022-03-02 20:25:24,2022-03-02 20:25:24
"758ef2ad-05bb-4a66-8a2d-e1be5e42fb64",34,55,-21,0.220779220779221,39,14,53,"Positive","Vil arrangere 1.000 kirkekoncerter for at hjælpe ukrainere (758ef2ad-05bb-4a66-8a2d-e1be5e42fb64)",2022-03-01 05:26:25,2022-03-01 05:26:25
"76a21195-f6cb-4cff-82dc-46a922d06763",-7,34,-41,-0.0463576158940397,29,26,55,"Negative","Gaspriser stiger på grund af Ukraine-krisen: Fynske tomater presses på prisen (76a21195-f6cb-4cff-82dc-46a922d06763)",2022-03-01 18:43:50,2022-03-01 18:43:50
"76d1f572-6f35-4261-8df6-827677c7ae9c",6,40,-34,0.0344827586206897,28,21,49,"Positive","Sikkerhedsbrist i tre systemer: Region Syddanmark melder sig selv (76d1f572-6f35-4261-8df6-827677c7ae9c)",2022-02-04 19:39:04,2022-02-04 19:39:04
"773e7a99-3da2-4cbd-8454-d0fa64a3132b",7,11,-4,0.0875,8,3,11,"Positive","Fængselsstraf og farvel til kørekort: 24-årig får konfiskeret søsters bil efter vanvidskørsel (773e7a99-3da2-4cbd-8454-d0fa64a3132b)",2022-01-20 19:18:00,2022-01-20 19:18:00
"779e4ce2-82d0-4c38-949a-632f4b609a5a",2,19,-17,0.0204081632653061,13,13,26,"Positive","Lastbil vælter i kraftig blæst på Storebæltsbroen (779e4ce2-82d0-4c38-949a-632f4b609a5a)",2022-01-17 06:08:04,2022-01-17 06:08:04
"77b88ec9-f11f-47a0-88fb-2486083f0bee",64,108,-44,0.237037037037037,59,29,88,"Positive","Lise-Lotte og Lars jubler: Badehotellet genopstår - men uden musik (77b88ec9-f11f-47a0-88fb-2486083f0bee)",2022-02-19 12:08:59,2022-02-19 12:08:59
"77e3d586-38e3-487b-8d62-67106ea742d2",-9,18,-27,-0.0608108108108108,16,19,35,"Negative","Stormen Malik udløser varsling om farligt vejr (77e3d586-38e3-487b-8d62-67106ea742d2)",2022-01-29 10:15:00,2022-01-29 07:02:10
"783a0748-a13f-48d1-ac2d-127b7fbb76fa",1,18,-17,0.0101010101010101,12,15,27,"Positive","Styrelse skifter strategi: Corona kan kun undtagelsesvist lukke skoler (783a0748-a13f-48d1-ac2d-127b7fbb76fa)",2022-01-14 08:56:57,2022-01-14 08:56:57
"783f3033-968a-42f1-9e63-26d5e8015098",1,10,-9,0.02,10,6,16,"Positive","Nora aftager henover lørdag: stadig risiko for hård kuling på Fyn (783f3033-968a-42f1-9e63-26d5e8015098)",2022-02-19 07:36:03,2022-02-19 07:36:03
"78b24fc7-05e8-4aec-b477-efb2977059cf",9,39,-30,0.06,27,22,49,"Positive","Alis frygter næste varmeregning: - Jeg sparer, hvor jeg kan (78b24fc7-05e8-4aec-b477-efb2977059cf)",2022-01-18 17:57:07,2022-01-18 17:57:07
"78f11077-bae5-417b-9e76-8323b908a783",27,39,-12,0.223140495867769,23,11,34,"Positive","Odense Håndbold knuser svenskere og sikrer CL-avancement (78f11077-bae5-417b-9e76-8323b908a783)",2022-02-06 16:45:58,2022-02-06 16:45:58
"7956d9a9-9280-454f-a769-8af7d1501a32",-41,42,-83,-0.224043715846995,35,66,101,"Negative","Voldsom stigning af influenzasmittede udfordrer OUH (7956d9a9-9280-454f-a769-8af7d1501a32)",2022-03-18 13:47:59,2022-03-18 13:47:59
"7a5e7a34-6146-44da-9bba-857de846d852",-7,4,-11,-0.145833333333333,3,9,12,"Negative","Tirsdagens coronatal: Se smittetrykket der, hvor du bor (7a5e7a34-6146-44da-9bba-857de846d852)",2022-01-11 13:56:36,2022-01-11 13:56:36
"7a968b36-c58f-4722-a7d4-bea80eeff5b2",0,41,-41,0,33,32,65,"Negative","Danmark nærmer sig flokimmunitet: - Nu står vi over for afgørende opgave i 2022, siger ekspert (7a968b36-c58f-4722-a7d4-bea80eeff5b2)",2022-01-25 06:35:23,2022-01-25 06:35:23
"7aded790-2a01-4d72-b5ea-46801ec806f1",5,19,-14,0.0480769230769231,9,8,17,"Positive","Danmark vinder EM-bronze - knap halvdelen har tilknytning til Fyn (7aded790-2a01-4d72-b5ea-46801ec806f1)",2022-01-30 16:22:27,2022-01-30 16:22:27
"7aeafc47-af2f-431e-91ed-cc629af727cf",22,36,-14,0.213592233009709,20,10,30,"Positive","Musikfestival er tilbage efter pause: - Vi har jo savnet det her (7aeafc47-af2f-431e-91ed-cc629af727cf)",2022-02-12 18:58:19,2022-02-12 18:58:19
"7aeca80d-ecdc-42c8-9524-ad614c0c6ab7",28,50,-22,0.177215189873418,37,15,52,"Positive","Før torsdagens slotsdebat: Ny museumslov skal ikke tilgodese slotsprojekt (7aeca80d-ecdc-42c8-9524-ad614c0c6ab7)",2022-02-24 09:37:51,2022-02-24 09:37:51
"7afb5af8-5b3b-4b10-b68e-65bd4526ec19",16,31,-15,0.158415841584158,16,14,30,"Positive","GOG slår Skjern i forårsåbner efter forskrækkelse (7afb5af8-5b3b-4b10-b68e-65bd4526ec19)",2022-02-05 17:23:25,2022-02-05 17:23:25
"7b23573c-3e7e-4b48-993d-64b7e111a900",40,43,-3,0.434782608695652,28,3,31,"Positive","Historisk stor lønaftale: Syv millioner kroner til sosu'erne (7b23573c-3e7e-4b48-993d-64b7e111a900)",2022-03-04 08:15:47,2022-03-04 08:15:47
"7b708806-aeaf-4837-8966-3a2f52130d19",18,25,-7,0.25,17,6,23,"Positive","Fynsk bank præsenterer stort overskud (7b708806-aeaf-4837-8966-3a2f52130d19)",2022-02-24 05:15:24,2022-02-24 05:15:24
"7bd278a5-6289-4975-b178-0b34aedc26be",44,55,-11,0.323529411764706,36,11,47,"Positive","Mathias får mere i løn end andre sosu’er: - Det er prioriteret herovre (7bd278a5-6289-4975-b178-0b34aedc26be)",2022-02-17 18:11:30,2022-02-17 18:11:30
"7bd783c1-d2f5-46c0-af46-203db3399b6b",10,14,-4,0.149253731343284,10,4,14,"Positive","Find paraplyen frem: Torsdag bliver en våd og grå affære (7bd783c1-d2f5-46c0-af46-203db3399b6b)",2022-02-03 06:36:31,2022-02-03 06:36:31
"7c2c3a45-f556-436c-becf-f014d1f104a0",13,38,-25,0.0977443609022556,24,18,42,"Positive","Ny særudstilling: Naturama åbner for fortidens monstre og krybdyr (7c2c3a45-f556-436c-becf-f014d1f104a0)",2022-02-09 05:46:23,2022-02-09 05:46:23
"7cc5ab33-249b-43df-b6b8-c937422ac09e",-16,45,-61,-0.0686695278969957,37,48,85,"Negative","Eksperternes bud: Er det snart slut med at isolere sig? (7cc5ab33-249b-43df-b6b8-c937422ac09e)",2022-01-15 12:23:29,2022-01-15 12:23:29
"7d8780bc-b286-4e90-a38e-6115c839a990",15,35,-20,0.107142857142857,25,12,37,"Positive","Isvinter på museet: Niårige Elias hugger skulpturer i historiens navn (7d8780bc-b286-4e90-a38e-6115c839a990)",2022-02-19 10:30:37,2022-02-19 10:30:37
"7e3689fa-a6f8-47df-a187-32ab582616e9",-28,8,-36,-0.256880733944954,6,19,25,"Negative","Overblik: Her er alle uheldene med letbanetog i Odense (7e3689fa-a6f8-47df-a187-32ab582616e9)",2022-01-09 07:50:00,2021-12-22 18:34:20
"7e86dd31-fbd1-466d-85bf-ab5fa918b864",-22,30,-52,-0.126436781609195,21,31,52,"Negative","Krig i Ukraine: Sådan rammes din privatøkonomi (7e86dd31-fbd1-466d-85bf-ab5fa918b864)",2022-02-26 06:15:50,2022-02-26 06:15:50
"7e89ad63-397f-433c-9796-3cdf28104bc5",-1,41,-42,-0.00591715976331361,35,26,61,"Negative","Voldsomt vejr: Her er der varsel om orkan og oversvømmelser (7e89ad63-397f-433c-9796-3cdf28104bc5)",2022-01-28 14:47:30,2022-01-28 14:47:30
"7eefe64f-21e5-4feb-a1e8-cfa27b39bf56",10,38,-28,0.078125,24,17,41,"Positive","Gymnasier hjælper Ukraine: Nyborg Gymnasium har indsamlet over 20.000 kroner (7eefe64f-21e5-4feb-a1e8-cfa27b39bf56)",2022-03-02 17:46:17,2022-03-02 17:46:17
"7eaa9976-41c5-4cd2-9ebe-c3e35d6c3826",-10,14,-24,-0.111111111111111,10,15,25,"Negative","Coronakurven er knækket: Smittetallet falder i alle fynske kommuner - undtagen én (7eaa9976-41c5-4cd2-9ebe-c3e35d6c3826)",2022-02-21 14:55:22,2022-02-21 14:55:22
"7f2abc1a-2d00-49e7-ae92-e3d30a7865bc",4,9,-5,0.142857142857143,5,4,9,"Positive","Få overblikket: De spiller på fynske musikfestivaler i 2022 (7f2abc1a-2d00-49e7-ae92-e3d30a7865bc)",2022-02-04 18:23:54,2022-02-04 18:23:54
"7f4b1201-eaf9-4d16-a0bc-e6d2e39dc52f",2,14,-12,0.0294117647058824,11,9,20,"Positive","Mandagens coronatal: Over 10.000 fynboer smittet på en uge (7f4b1201-eaf9-4d16-a0bc-e6d2e39dc52f)",2022-01-10 14:53:37,2022-01-10 14:53:37
"7fe70ecc-06ca-48d5-b209-ebbf6c628519",2,8,-6,0.0338983050847458,6,5,11,"Positive","Regnfront på vej mod Fyn (7fe70ecc-06ca-48d5-b209-ebbf6c628519)",2022-01-19 05:42:29,2022-01-19 05:42:29
"7aa661db-61fc-487f-a829-5f1910f2aee3",15,64,-49,0.0753768844221105,37,31,68,"Positive","Naboer til Nyborg Slot: - Til grin og pinligt (7aa661db-61fc-487f-a829-5f1910f2aee3)",2022-02-13 10:05:08,2022-02-13 10:05:08
"8013b1ab-29bf-4f8a-acf6-8b907e50013d",19,44,-25,0.159663865546218,27,16,43,"Positive","Se videoen: Kom med fynske ishockeykvinder ind i OL-byen (8013b1ab-29bf-4f8a-acf6-8b907e50013d)",2022-02-07 05:58:33,2022-02-07 05:58:33
"806f9132-45ec-4548-854e-6f9733798221",7,26,-19,0.0546875,22,15,37,"Positive","Fynske Heindahl ser tiden an og forholder sig til Moskva-kontrakt (806f9132-45ec-4548-854e-6f9733798221)",2022-03-01 12:32:45,2022-03-01 12:32:45
"80ee74cf-c784-48c5-b1d3-bb067c07e452",19,23,-4,0.345454545454545,14,3,17,"Positive","Kommunaldirektør står til at blive fyret (80ee74cf-c784-48c5-b1d3-bb067c07e452)",2022-01-27 20:46:41,2022-01-27 20:46:41
"80eead9e-3dc1-4464-834a-f0483bf440e5",34,61,-27,0.215189873417722,41,17,58,"Positive","Graviditet, kondomer og kønssygdomme: - Undervisningen skal revolutioneres (80eead9e-3dc1-4464-834a-f0483bf440e5)",2022-02-07 16:31:08,2022-02-07 16:31:08
"810f2d53-699f-4029-bd76-1b609a89f11b",-2,19,-21,-0.0246913580246914,11,16,27,"Negative","Søndag starter grå og kølig – men solen kommer senere (810f2d53-699f-4029-bd76-1b609a89f11b)",2022-03-20 07:45:14,2022-03-20 07:45:14
"8177212a-37d6-4ebb-ac82-f05950ff9158",29,71,-42,0.118367346938776,46,29,75,"Positive","Trods antydninger om det modsatte: Fynske støtter bliver i partiet efter Henriksen-exit (8177212a-37d6-4ebb-ac82-f05950ff9158)",2022-02-11 12:47:34,2022-02-11 12:47:34
"81d4bcd2-d969-44ea-99b9-efcff529021a",17,34,-17,0.197674418604651,22,8,30,"Positive","Her blev Jacobsen klar over, at Gidsel er noget særligt (81d4bcd2-d969-44ea-99b9-efcff529021a)",2022-01-28 18:33:33,2022-01-28 18:33:33
"81f3589f-a0a4-42af-9b0c-fa8b2ac38fee",-3,12,-15,-0.0394736842105263,10,13,23,"Negative","Lørdagens coronatal: Smitten stiger på Fyn -  men mest i Odense (81f3589f-a0a4-42af-9b0c-fa8b2ac38fee)",2022-02-12 14:16:07,2022-02-12 14:16:07
"8208267e-7eb8-4865-a19f-110fb1da3726",-16,62,-78,-0.0521172638436482,47,50,97,"Negative","Marie-louises søn sov få meter fra højspændingskabel: - Jeg forstår ikke, man kan behandle sine borgere sådan (8208267e-7eb8-4865-a19f-110fb1da3726)",2022-02-21 08:25:00,2022-02-21 07:56:31
"82602d79-faeb-4128-89d9-f23cab92889b",3,11,-8,0.0625,6,7,13,"Positive","Solrig søndag uden vind (82602d79-faeb-4128-89d9-f23cab92889b)",2022-03-06 06:45:55,2022-03-06 06:45:55
"82be7546-75d4-479c-bfbe-74ce0b285043",29,38,-9,0.193333333333333,24,7,31,"Positive","Læs svarene: Fynboer fik svar på spørgsmål om nye tider på Lindø (82be7546-75d4-479c-bfbe-74ce0b285043)",2022-01-20 18:12:16,2022-01-20 18:12:16
"837dd8f7-9b22-4c36-9445-feee2bfced7f",5,18,-13,0.0568181818181818,12,10,22,"Positive","Tæt på 500.000 coronatest foretaget i regionen den seneste uge (837dd8f7-9b22-4c36-9445-feee2bfced7f)",2022-01-21 20:55:07,2022-01-21 20:55:07
"8394c6d4-cc5a-42c4-811c-6f9e1cf7f362",-11,11,-22,-0.1375,9,17,26,"Negative","Antallet af smittede falder igen på Fyn (8394c6d4-cc5a-42c4-811c-6f9e1cf7f362)",2022-02-16 13:41:03,2022-02-16 13:41:03
"8438ec93-4bd5-4789-8b6f-cbe8fd2e5f08",-19,139,-158,-0.0303514376996805,95,89,184,"Negative","Den bramfri partisoldat ville rydde op i Forsvaret, men stødte på grund undervejs (8438ec93-4bd5-4789-8b6f-cbe8fd2e5f08)",2022-01-15 06:09:51,2022-01-15 06:09:51
"846cb00e-5540-454e-80eb-0ec8edc5d2ea",9,25,-16,0.136363636363636,13,10,23,"Positive","Endnu en solskinssøndag til Fyn (846cb00e-5540-454e-80eb-0ec8edc5d2ea)",2022-02-27 06:32:25,2022-02-27 06:32:25
"8529390c-8831-4034-bbe0-bc932e907dd8",13,17,-4,0.196969696969697,9,3,12,"Positive","Kampen minut for minut: 6.153 så OB tabe med 3-2 til AaB (8529390c-8831-4034-bbe0-bc932e907dd8)",2022-03-14 19:59:00,2022-03-14 17:40:46
"854b4b14-bb2f-4224-a4b1-fae0e1bedb6e",0,22,-22,0,13,14,27,"Negative","Corona sender fynsk rejseselskab i rødt: Færre ansatte efter nyt underskud (854b4b14-bb2f-4224-a4b1-fae0e1bedb6e)",2022-02-12 10:05:09,2022-02-12 10:05:09
"855fd639-e969-4dad-bca1-205be50226aa",15,51,-36,0.105633802816901,37,19,56,"Positive","Nu skal det koste kassen at bo i kolonihaven hele året (855fd639-e969-4dad-bca1-205be50226aa)",2022-02-02 15:26:28,2022-02-02 15:26:28
"85bc6965-bb3b-41cd-9a3b-1da7adf917f7",-3,24,-27,-0.0275229357798165,17,17,34,"Negative","Fortrolig mail afslører lovbrud: Opdigtede informationer kunne føre til tvangsfjernelse (85bc6965-bb3b-41cd-9a3b-1da7adf917f7)",2022-03-22 05:02:17,2022-03-22 05:02:17
"85f27ae9-592f-4102-aa97-8d15317d99a2",28,39,-11,0.16,28,10,38,"Positive","Årets næste juleeventyr foregår på Fyn: - Det gør meget, at det ikke er i et studie (85f27ae9-592f-4102-aa97-8d15317d99a2)",2022-02-11 16:56:55,2022-02-11 16:56:55
"865b5408-69ff-4cd1-867d-2f158224706b",15,40,-25,0.105633802816901,33,15,48,"Positive","16-årige Amalie fortalte hele Danmark dét, hun skammede sig over i flere år: - Jeg tror, at had bunder i uvidenhed (865b5408-69ff-4cd1-867d-2f158224706b)",2022-01-27 08:22:22,2022-01-27 08:22:22
"8661d450-c6b0-4705-9ba0-eadb1f3dc64c",18,39,-21,0.183673469387755,23,11,34,"Positive","Odense vender truende nederlag og drøner i pokalfinalen (8661d450-c6b0-4705-9ba0-eadb1f3dc64c)",2022-02-26 14:21:36,2022-02-26 14:21:36
"86679fa6-174a-4c88-8dcc-8eea186a652b",78,84,-6,0.629032258064516,42,4,46,"Positive","Ketsjerkongen kåret igen: Viktor Axelsen rydder bordet (86679fa6-174a-4c88-8dcc-8eea186a652b)",2022-01-22 06:07:30,2022-01-22 06:07:30
"86801f08-53e5-40bc-b16e-b573105d5643",1,17,-16,0.00892857142857143,13,13,26,"Positive","Regeringen kommer med plan for restriktionerne på onsdag (86801f08-53e5-40bc-b16e-b573105d5643)",2022-01-20 18:24:53,2022-01-20 18:24:53
"86af86fb-5aa4-4486-bb2f-c2139e3eb52c",-1,7,-8,-0.0178571428571429,6,5,11,"Negative","Vinterligt vejr på vej til Fyn (86af86fb-5aa4-4486-bb2f-c2139e3eb52c)",2022-01-31 05:49:56,2022-01-31 05:49:56
"86d03d0e-b125-4f51-930d-21ceceaed908",-8,17,-25,-0.0540540540540541,15,18,33,"Negative","Unge filmer og deler sammenstød på trafikeret vej: Nu efterforsker politiet sagen (86d03d0e-b125-4f51-930d-21ceceaed908)",2022-01-11 14:49:08,2022-01-11 14:49:08
"86f81a29-d707-45ed-8388-1e1e3359b06e",-2,18,-20,-0.0175438596491228,11,12,23,"Negative","Tidligere Venstre-minister Britta Schall Holberg er død - 80 år (86f81a29-d707-45ed-8388-1e1e3359b06e)",2022-02-24 17:01:46,2022-02-24 17:01:46
"86fe84a0-28c8-4498-9825-4d993168444c",-1,16,-17,-0.0120481927710843,12,13,25,"Negative","Se tal for dit område: Smitten sætter endnu engang rekord (86fe84a0-28c8-4498-9825-4d993168444c)",2022-01-21 13:33:09,2022-01-21 13:33:09
"871a0ac1-2e46-4613-a596-0443e0661a3e",-3,5,-8,-0.06,4,6,10,"Negative","Solrig start på weekenden (871a0ac1-2e46-4613-a596-0443e0661a3e)",2022-01-14 05:51:26,2022-01-14 05:51:26
"87f8c599-92d6-4481-9318-c15630194f60",-6,25,-31,-0.0434782608695652,20,22,42,"Negative","Høj immunitet i hovedstaden skubber smitte mod Fyn - og den har ikke toppet endnu (87f8c599-92d6-4481-9318-c15630194f60)",2022-02-10 19:53:05,2022-02-10 19:53:05
"881dbdba-e0cf-4064-a2e0-21facee647e9",-1,4,-5,-0.0588235294117647,2,3,5,"Negative","Stormen Nora på vej til Fyn: Sådan forbereder du dig (881dbdba-e0cf-4064-a2e0-21facee647e9)",2022-02-17 12:23:52,2022-02-17 12:23:52
"888ed76d-5406-4dba-a89d-4f74da5a38b6",14,15,-1,0.184210526315789,12,1,13,"Positive","Se debatten: 380 nye arbejdspladser på vej på Lindø (888ed76d-5406-4dba-a89d-4f74da5a38b6)",2022-01-20 15:42:05,2022-01-20 15:42:05
"8997fd20-52a9-4260-b127-0d87cfe7830d",40,57,-17,0.209424083769634,34,9,43,"Positive","Dronningens jubilæum: Carsten var den første fynbo, der vidste, at kongen var død (8997fd20-52a9-4260-b127-0d87cfe7830d)",2022-01-14 11:39:00,2022-01-14 11:38:00
"89ed098f-6ee3-45b0-a1f1-a10a3a4ae2dd",-8,30,-38,-0.0776699029126214,22,25,47,"Negative","Nu anbefales coronatest kun i særlige tilfælde (89ed098f-6ee3-45b0-a1f1-a10a3a4ae2dd)",2022-03-10 12:55:13,2022-03-10 12:55:13
"8a11827c-c30d-4239-917e-309b47c5ed0f",74,88,-14,0.437869822485207,45,10,55,"Positive","Landsholdet og stab reddede Christian Eriksen - nu vinder de stor Fair Play-pris (8a11827c-c30d-4239-917e-309b47c5ed0f)",2022-01-17 20:12:25,2022-01-17 20:12:25
"8a2b423e-f257-4251-93db-f5b4e2c97d61",1,6,-5,0.0227272727272727,5,5,10,"Positive","Minut for minut: OB spiller uafgjort mod FC Midtjylland på hjemmebane (8a2b423e-f257-4251-93db-f5b4e2c97d61)",2022-02-27 17:07:20,2022-02-27 17:07:20
"8ab9beaa-b691-4322-adcc-720609345dcc",19,31,-12,0.195876288659794,16,10,26,"Positive","Eriksen tør næsten ikke tænke på sit comeback til landsholdet (8ab9beaa-b691-4322-adcc-720609345dcc)",2022-02-14 09:02:24,2022-02-14 09:02:24
"8ad348ab-9b69-4e93-a9c8-763898d0fb9f",30,40,-10,0.306122448979592,23,6,29,"Positive","Det Fynske Dyrskue skal have ny chef (8ad348ab-9b69-4e93-a9c8-763898d0fb9f)",2022-02-09 12:06:48,2022-02-09 12:06:48
"8ae382b2-9275-4802-aefc-bbbf679b723f",-25,21,-46,-0.183823529411765,17,29,46,"Negative","Overblik over aflysninger på Fyn: Trafikken rammes hårdt af stormen Nora (8ae382b2-9275-4802-aefc-bbbf679b723f)",2022-02-18 11:15:00,2022-02-18 09:30:35
"8b50a497-1d52-4298-bb00-e46897ce9071",70,79,-9,0.454545454545455,48,6,54,"Positive","Savner hjælpende hænder: Frivillig til Tour de France - er det noget for dig? (8b50a497-1d52-4298-bb00-e46897ce9071)",2022-01-20 19:49:00,2022-01-20 19:49:00
"8b641cac-35b2-4f8c-9290-e202187abf81",-10,15,-25,-0.0952380952380952,13,14,27,"Negative","Travlhed hos politiet: Forældre kimede Fyns Politi ned på første festaften efter genåbning (8b641cac-35b2-4f8c-9290-e202187abf81)",2022-02-05 07:16:22,2022-02-05 07:16:22
"8b6f4baa-41cb-4df0-a790-746f44369134",26,50,-24,0.171052631578947,31,14,45,"Positive","Mette Frederiksen om Bramsens skifte til transportminister: - Det er Enhedslisten, der har ønsket ændringer (8b6f4baa-41cb-4df0-a790-746f44369134)",2022-02-04 16:03:21,2022-02-04 16:03:21
"8bf68620-27bc-4892-9b20-3551c349ff77",-5,54,-59,-0.0292397660818713,40,28,68,"Negative","- Det gør ondt i maven på os alle, siger Krickau om Gidsels skade (8bf68620-27bc-4892-9b20-3551c349ff77)",2022-02-02 07:30:44,2022-02-02 07:30:44
"8bfebaeb-3d17-4117-bed5-0564ebac8e99",-43,65,-108,-0.206730769230769,41,57,98,"Negative","Vold mod personalet: Dårligt arbejdsmiljø på akutmodtagelsen i Odense (8bfebaeb-3d17-4117-bed5-0564ebac8e99)",2022-01-11 17:05:04,2022-01-11 17:05:04
"8c38c011-d8db-4d06-94e9-03d3cc5a56dd",23,41,-18,0.23,23,10,33,"Positive","Assens er klar til at hjælpe flygtninge: - Det er helt utilgiveligt, og vi står klar til at hjælpe (8c38c011-d8db-4d06-94e9-03d3cc5a56dd)",2022-03-02 20:45:55,2022-03-02 20:45:55
"8ca4c6ec-1b96-4415-b7ca-cd946dd790e4",-21,20,-41,-0.221052631578947,12,21,33,"Negative","Fynbo, er du bange? (8ca4c6ec-1b96-4415-b7ca-cd946dd790e4)",2022-03-04 19:12:55,2022-03-04 19:12:55
"8ca9d624-9cac-4015-9c10-65af1eb5c4b5",0,7,-7,0,6,5,11,"Negative","Se hele debatten: Er det uetisk at holde vilde dyr i zoo? (8ca9d624-9cac-4015-9c10-65af1eb5c4b5)",2022-01-27 17:00:00,2022-01-27 15:55:17
"8ce517c4-c82f-4dbf-a982-127d5253f3e6",19,21,-2,0.287878787878788,11,2,13,"Positive","Axelsen går i stå i tredje sæt og misser tysk finale (8ce517c4-c82f-4dbf-a982-127d5253f3e6)",2022-03-12 18:17:57,2022-03-12 18:17:57
"8ceddbfa-a657-400e-a2e1-3dfc29ebc76a",2,11,-9,0.0212765957446809,9,6,15,"Positive","Letbanen nærmer sig den afsluttende testfase (8ceddbfa-a657-400e-a2e1-3dfc29ebc76a)",2022-03-21 10:53:20,2022-03-21 10:53:20
"8d4a39cc-dc8a-4c27-a6c3-9ce8cac7e116",23,40,-17,0.181102362204724,28,11,39,"Positive","Hvad skal man være opmærksom på, inden man åbner sit hjem for flygtninge? (8d4a39cc-dc8a-4c27-a6c3-9ce8cac7e116)",2022-03-04 07:12:44,2022-03-04 07:12:44
"8d79ddbc-1fe6-45cf-900b-a8e32c1acc22",37,70,-33,0.198924731182796,49,24,73,"Positive","Bliver du ikke smittet, mens alle omkring dig har coronavirus? Nyt studie giver bud på hvorfor (8d79ddbc-1fe6-45cf-900b-a8e32c1acc22)",2022-02-04 07:37:21,2022-02-04 07:37:21
"8dfa9169-9966-454a-8090-6e5bf19d5f95",18,25,-7,0.253521126760563,21,4,25,"Positive","Landsholdsbobler forlænger med GOG trods udlandstilbud (8dfa9169-9966-454a-8090-6e5bf19d5f95)",2022-02-08 15:55:22,2022-02-08 15:55:22
"8e201067-7acb-489e-8f85-c25d42f611ae",0,32,-32,0,22,20,42,"Negative","Det anbefaler partierne ved en folkeafstemning (8e201067-7acb-489e-8f85-c25d42f611ae)",2022-03-07 08:04:29,2022-03-07 08:04:29
"8e530d95-7401-4410-97d2-ff544e434c31",28,43,-15,0.25,29,11,40,"Positive","Nu reagerer OB på kritik: Overskud fra legendetrøje doneres ubeskåret til kræftforskning (8e530d95-7401-4410-97d2-ff544e434c31)",2022-02-16 11:53:02,2022-02-16 11:53:02
"8e97b8ae-a7dd-4b1f-9bf5-bbde0e73151e",2,35,-33,0.0112359550561798,26,23,49,"Positive","Plast på vej til at blive det mest klimavenlige: Kan laves af luft og vand (8e97b8ae-a7dd-4b1f-9bf5-bbde0e73151e)",2022-02-02 12:05:25,2022-02-02 12:05:25
"8f16e831-d852-47b9-bfe0-7e9ea2703b14",-32,10,-42,-0.323232323232323,8,20,28,"Negative","Politiet efterlyser overvågningsbilleder af flugtbil efter drab i Odense (8f16e831-d852-47b9-bfe0-7e9ea2703b14)",2022-03-09 10:13:24,2022-03-09 10:13:24
"8f50b9fe-7da4-4450-88af-79f93d0858aa",-13,21,-34,-0.12621359223301,17,22,39,"Negative","Fjerde sure smiley i træk: Købmand får bøde og politianmeldes (8f50b9fe-7da4-4450-88af-79f93d0858aa)",2022-01-24 16:42:46,2022-01-24 16:42:46
"8fad8124-f162-4990-9f4a-a920081606ea",10,30,-20,0.0925925925925926,21,16,37,"Positive","Biografer vil have klarhed om restriktioner (8fad8124-f162-4990-9f4a-a920081606ea)",2022-01-10 15:16:06,2022-01-10 15:16:06
"8fe3104e-93a2-4758-9a79-fe3daaeb5580",8,34,-26,0.0606060606060606,24,16,40,"Positive","Oscarvinder filmatiserer fynsk krigshistorie (8fe3104e-93a2-4758-9a79-fe3daaeb5580)",2022-03-15 09:06:00,2022-03-15 09:06:00
"8aa47cf5-7cf2-4f1b-b19d-0879eb038d91",1,5,-4,0.02,3,4,7,"Positive","Varsel om vandstand nedtonet (8aa47cf5-7cf2-4f1b-b19d-0879eb038d91)",2022-01-28 05:51:24,2022-01-28 05:51:24
"9074bd41-5dc8-4ce9-9723-5aace04d5fe4",-16,9,-25,-0.246153846153846,5,12,17,"Negative","Rema-røver med særlig gangart anholdt (9074bd41-5dc8-4ce9-9723-5aace04d5fe4)",2022-02-04 12:50:37,2022-02-04 12:50:37
"90d35d11-ec85-45e4-b460-4c7c975a1403",1,41,-40,0.00826446280991736,25,22,47,"Positive","Gidsel forklarer Jacobsens skideballe i pausen (90d35d11-ec85-45e4-b460-4c7c975a1403)",2022-01-23 06:52:05,2022-01-23 06:52:05
"90f886b2-2dc2-4886-8999-b34485c12fb3",16,52,-36,0.0747663551401869,42,28,70,"Positive","Sådan har prisen for at krydse Storebælt ændret sig (90f886b2-2dc2-4886-8999-b34485c12fb3)",2022-02-21 21:03:02,2022-02-21 21:03:02
"917033d8-1502-4c91-b93e-f9d7ed6b3774",-13,38,-51,-0.0935251798561151,23,33,56,"Negative","Hotelejer fortsætter med krav om mundbind og coronapas - men må hun egentlig det? (917033d8-1502-4c91-b93e-f9d7ed6b3774)",2022-02-01 18:18:06,2022-02-01 18:18:06
"919f4ac3-070d-4d45-9d3b-43c76304f36b",24,40,-16,0.263736263736264,21,13,34,"Positive","Odense Håndbold udnytter konkurrenters kiks i toppen (919f4ac3-070d-4d45-9d3b-43c76304f36b)",2022-01-27 19:06:29,2022-01-27 19:06:29
"91daa686-5690-424a-85bd-7b65267cba42",21,31,-10,0.15,23,6,29,"Positive","Festival fylder scenen med markante kvinder (91daa686-5690-424a-85bd-7b65267cba42)",2022-01-25 11:00:12,2022-01-25 11:00:12
"9206708e-8300-4b3b-953e-2ebc5f1fdedb",8,40,-32,0.0655737704918033,23,21,44,"Positive","GOG får tyske tæv i europæisk gruppeafslutning (9206708e-8300-4b3b-953e-2ebc5f1fdedb)",2022-03-08 19:31:14,2022-03-08 19:31:14
"92dc11ec-8ec0-4bbe-98b2-f321afa12b84",-12,30,-42,-0.0882352941176471,21,28,49,"Negative","Ikke alle er trygge ved genåbningen - det er lidt af et eksperiment, mener professor (92dc11ec-8ec0-4bbe-98b2-f321afa12b84)",2022-01-31 11:18:58,2022-01-31 11:18:58
"92f62525-8e97-4e90-8af9-d74aa8ce8181",13,19,-6,0.110169491525424,14,6,20,"Positive","1.000 år gammel bygning fundet på Fyn (92f62525-8e97-4e90-8af9-d74aa8ce8181)",2022-02-02 17:45:54,2022-02-02 17:45:54
"936e448d-df9a-4972-8610-855e61de5202",-1,8,-9,-0.0192307692307692,7,6,13,"Negative","Smitten falder stadig - se udviklingen i din kommune (936e448d-df9a-4972-8610-855e61de5202)",2022-02-17 13:50:45,2022-02-17 13:50:45
"938f2afc-b230-479a-863b-fac4422699eb",1,8,-7,0.0175438596491228,8,4,12,"Positive","Nye oversvømmelser på vej mod Fyn (938f2afc-b230-479a-863b-fac4422699eb)",2022-01-27 11:12:12,2022-01-27 11:12:12
"93dafe8c-a495-407e-9131-56799d8a59ae",-6,16,-22,-0.0625,15,13,28,"Negative","Fynsk galleri inviterer russiske kunstnere til at udstille: - Man kan ikke skære alle over en kam (93dafe8c-a495-407e-9131-56799d8a59ae)",2022-03-17 18:16:39,2022-03-17 18:16:39
"940bcc98-fa32-43ba-b25e-32a5055f2846",-19,38,-57,-0.121794871794872,31,46,77,"Negative","Hvert år dør flere af livsfarligt byggestøv - nu går særlig indsats i gang (940bcc98-fa32-43ba-b25e-32a5055f2846)",2022-03-17 06:45:56,2022-03-17 06:45:56
"942aa8bf-d7d9-4450-a45f-b1abb8060d3e",1,21,-20,0.00617283950617284,15,16,31,"Positive","Disse restriktioner vil Epidemikommissionen fjerne - og beholde (942aa8bf-d7d9-4450-a45f-b1abb8060d3e)",2022-01-12 07:48:32,2022-01-12 07:48:32
"945412bd-d6a1-4fb5-b069-80e5fca5bd5b",-11,25,-36,-0.0802919708029197,21,25,46,"Negative","PFOS fundet i søer ved Svendborg - græssende køer skal undersøges (945412bd-d6a1-4fb5-b069-80e5fca5bd5b)",2022-01-28 08:58:50,2022-01-28 08:58:50
"9468d719-540a-46ae-bbc9-09a4b7013cd5",-16,32,-48,-0.16,27,20,47,"Negative","Knap hver anden kommunalvalgskandidat blev udsat for chikane (9468d719-540a-46ae-bbc9-09a4b7013cd5)",2022-02-16 07:14:03,2022-02-16 07:14:03
"95b0c155-b584-42a1-80b4-28a83031c725",23,30,-7,0.201754385964912,24,4,28,"Positive","Flertal trumfer regeringen - hæver forsamlingsloft ved indendørs kulturarrangementer (95b0c155-b584-42a1-80b4-28a83031c725)",2022-01-13 13:51:44,2022-01-13 13:51:44
"95c02f3f-328a-4cb7-ad7f-6cf906f75d9e",-3,3,-6,-0.0681818181818182,3,4,7,"Negative","Stråtækt gård stod i store flammer (95c02f3f-328a-4cb7-ad7f-6cf906f75d9e)",2022-02-05 08:24:28,2022-02-05 08:24:28
"95d288c6-d917-4bcb-baee-b4c689172bbe",40,46,-6,0.363636363636364,29,4,33,"Positive","Ukrainske flygtninge ankommet til Korinth Kro: - Det er næsten ikke til at være i (95d288c6-d917-4bcb-baee-b4c689172bbe)",2022-03-03 14:29:45,2022-03-03 14:29:45
"9611cf83-1978-424e-acfa-aaf5b0cc2290",11,64,-53,0.0460251046025105,48,32,80,"Positive","Rådmand opfordrede kabelnaboer til at flytte: - Det var som at få en spand vand i hovedet (9611cf83-1978-424e-acfa-aaf5b0cc2290)",2022-02-25 18:49:11,2022-02-25 18:49:11
"96305798-5c36-470c-855e-e8ac9bdca184",-2,13,-15,-0.0263157894736842,11,9,20,"Negative","Odense Zoo måtte pludselig aflive ung løve (96305798-5c36-470c-855e-e8ac9bdca184)",2022-01-22 06:52:14,2022-01-22 06:52:14
"96c8b98e-c50a-4b12-a321-f0798b076bc4",-1,18,-19,-0.0119047619047619,16,11,27,"Negative","Efter fund af PFOS i fynsk kød: Kommunen står til rådighed med sparring (96c8b98e-c50a-4b12-a321-f0798b076bc4)",2022-01-19 19:27:25,2022-01-19 19:27:25
"978d93ec-de1f-4f30-8836-8fcfa7704486",9,18,-9,0.1125,13,5,18,"Positive","Vandmasser på vej: I Seden Standby har man kæmpet i syv år (978d93ec-de1f-4f30-8836-8fcfa7704486)",2022-01-15 11:35:23,2022-01-15 11:35:23
"97fe88bb-64d8-4da3-ae75-91285787b54c",-2,29,-31,-0.0135135135135135,22,17,39,"Negative","Ukrainer i Odense: - Min datter i Kiev er forskrækket over Putin (97fe88bb-64d8-4da3-ae75-91285787b54c)",2022-02-22 15:28:25,2022-02-22 15:28:25
"98151921-6b80-4872-a852-46f981049a25",-19,23,-42,-0.162393162393162,14,28,42,"Negative","131 corona-indlagte: Trods fald i smittetal er der stadig stort pres på OUH (98151921-6b80-4872-a852-46f981049a25)",2022-03-09 09:07:19,2022-03-09 09:07:19
"98348a5f-f725-44e3-b99f-8bb2e0dc6bdf",12,34,-22,0.0875912408759124,23,16,39,"Positive","Venstre vil sætte skub i byggeri af Nyborg Slot med lovforslag (98348a5f-f725-44e3-b99f-8bb2e0dc6bdf)",2022-01-13 11:47:03,2022-01-13 11:47:03
"98709e1e-7005-4717-a9a4-b5273c53bdb9",42,66,-24,0.392523364485981,40,13,53,"Positive","Center for Seksuelt Misbrug får pengegave: - Nu skal vi på café (98709e1e-7005-4717-a9a4-b5273c53bdb9)",2022-02-08 05:57:15,2022-02-08 05:57:15
"98778b26-93df-4ee2-a6d3-863280bf162f",46,109,-63,0.145569620253165,70,37,107,"Positive","90-årige Arne drømte om fællesskab: - Vi er blevet snydt, for kulden går ind i marv og ben (98778b26-93df-4ee2-a6d3-863280bf162f)",2022-01-12 13:16:58,2022-01-12 13:16:58
"98965097-3fa8-4da8-9903-248f44c88421",-14,53,-67,-0.0958904109589041,32,34,66,"Negative","Gidsel knust: - Jeg kan ikke afslutte min karriere i GOG (98965097-3fa8-4da8-9903-248f44c88421)",2022-02-05 15:50:36,2022-02-05 15:50:36
"98a6f0f6-89f3-4450-9651-8bb2042e744f",0,20,-20,0,14,15,29,"Negative","Christian Eriksen starter inde for Brentford i bundbrag (98a6f0f6-89f3-4450-9651-8bb2042e744f)",2022-03-05 14:55:02,2022-03-05 14:55:02
"98cd3065-3790-4200-ad81-4cbd6ba73ed6",5,26,-21,0.0581395348837209,15,14,29,"Positive","- Det er meget, meget specielt, siger Eriksen (98cd3065-3790-4200-ad81-4cbd6ba73ed6)",2022-02-26 18:21:54,2022-02-26 18:21:54
"990ded8a-ced4-42b7-a083-a631bd8195b7",22,62,-40,0.119565217391304,44,28,72,"Positive","Corona har sat social læring på standby: Gymnasium sætter fællesskab på skoleskemaet (990ded8a-ced4-42b7-a083-a631bd8195b7)",2022-01-31 17:44:16,2022-01-31 17:44:16
"993706fa-2db1-4476-b8cd-1701d1c27be0",8,14,-6,0.137931034482759,9,4,13,"Positive","Ugen begynder med mildt og gråt vejr (993706fa-2db1-4476-b8cd-1701d1c27be0)",2022-01-24 06:03:36,2022-01-24 06:03:36
"994c70dc-f69c-4026-baba-27a6d86ab153",18,28,-10,0.146341463414634,22,7,29,"Positive","Færge uden kaptajn: Danmarks første autonome færge bliver produceret på Fyn (994c70dc-f69c-4026-baba-27a6d86ab153)",2022-01-28 06:13:47,2022-01-28 06:13:47
"99e3673a-1a97-4961-aa9c-eafbdafb615c",1,13,-12,0.0144927536231884,9,11,20,"Positive","Se kort: Forhøjet vandstand rundt om Fyn kan blive hverdag (99e3673a-1a97-4961-aa9c-eafbdafb615c)",2022-01-10 16:33:32,2022-01-10 16:33:32
"9a1d795b-07b8-4666-9bf6-2e81f4ea90a7",0,11,-11,0,7,7,14,"Negative","Se eksperternes 10 gode råd til lejere (9a1d795b-07b8-4666-9bf6-2e81f4ea90a7)",2022-01-13 18:07:11,2022-01-13 18:07:11
"9a78b0b9-2dd0-4bc3-ade6-ac82be2c8e10",-1,27,-28,-0.00854700854700855,18,17,35,"Negative","Skal mindske dødsrisikoen: Millioner på vej til landets største amputationscenter (9a78b0b9-2dd0-4bc3-ade6-ac82be2c8e10)",2022-01-14 13:08:44,2022-01-14 13:08:44
"9a8fdb7a-b105-4a4c-8a34-b193403bc210",18,29,-11,0.134328358208955,20,9,29,"Positive","Nu kan småfisk i Lillebælt gå i børnehave og vokse sig store og stærke (9a8fdb7a-b105-4a4c-8a34-b193403bc210)",2022-02-10 06:01:54,2022-02-10 06:01:54
"9ac9a0ef-152f-49e3-8c91-853754bd5f7b",-8,9,-17,-0.0860215053763441,8,14,22,"Negative","Fortsat færre smittede på Fyn - se, hvordan det ser ud i din kommune (9ac9a0ef-152f-49e3-8c91-853754bd5f7b)",2022-02-07 14:14:56,2022-02-07 14:14:56
"9afedf63-daeb-41ff-895c-667d14de0adf",-7,4,-11,-0.112903225806452,3,8,11,"Negative","Se billederne: Forhøjet vandstand på Nordfyn (9afedf63-daeb-41ff-895c-667d14de0adf)",2022-01-17 08:53:55,2022-01-17 08:53:55
"9b0cebac-9e46-4c9d-be28-302401bdd36a",-18,22,-40,-0.132352941176471,14,28,42,"Negative","Demonstranter ved Baltic Pibe-sag: - Fossilt gas hører simpelthen fortiden til (9b0cebac-9e46-4c9d-be28-302401bdd36a)",2022-03-02 07:15:32,2022-03-02 07:15:32
"9b37b4a8-a222-4fe6-86e1-a9188bc7b115",35,74,-39,0.152173913043478,47,28,75,"Positive","William afprøvede alt fra badminton til skydning: - Det er fedt (9b37b4a8-a222-4fe6-86e1-a9188bc7b115)",2022-03-12 19:18:14,2022-03-12 19:18:14
"9b477c93-476a-45ac-827d-70827a5f593d",67,80,-13,0.345360824742268,50,12,62,"Positive","En af få udvalgte: Minister fra Fyn inviteret til at dele sin idé med verdensledere (9b477c93-476a-45ac-827d-70827a5f593d)",2022-02-03 16:00:15,2022-02-03 16:00:15
"9c9c231d-aed3-468c-91b8-15febb9e1ca0",1,17,-16,0.0104166666666667,13,11,24,"Positive","Se med live: Førstehjælp til lejere (9c9c231d-aed3-468c-91b8-15febb9e1ca0)",2022-01-13 15:55:11,2022-01-13 15:55:11
"9cca16b5-bcb3-49e2-9ac1-d5b65d4a6cc4",-3,31,-34,-0.0275229357798165,18,23,41,"Negative","Alle studser over episode med Eriksen (9cca16b5-bcb3-49e2-9ac1-d5b65d4a6cc4)",2022-03-06 10:01:33,2022-03-06 10:01:33
"9cd483ea-d07d-487d-a394-54b5fa9e346a",10,56,-46,0.078740157480315,35,23,58,"Positive","Efter ny rapport: Alarmerende mange har ondt i sjælen i Odense (9cd483ea-d07d-487d-a394-54b5fa9e346a)",2022-03-13 11:53:04,2022-03-13 11:53:04
"9cf94652-c32d-4977-9897-5741a3102782",1,3,-2,0.0227272727272727,3,1,4,"Positive","Politiet massivt til stede på adresse i Odense (9cf94652-c32d-4977-9897-5741a3102782)",2022-01-25 10:13:00,2022-01-25 10:13:00
"9d86f740-4d2e-42a9-8488-97d96269d8b5",12,39,-27,0.0576923076923077,32,19,51,"Positive","Her er restriktionerne, der forsvinder i dag (9d86f740-4d2e-42a9-8488-97d96269d8b5)",2022-01-16 06:21:13,2022-01-16 06:21:13
"9e575263-fd31-405e-bffc-4b0c3d506f59",-14,8,-22,-0.21875,6,15,21,"Negative","Dagens coronatal: Kun Ærø stiger i smitte (9e575263-fd31-405e-bffc-4b0c3d506f59)",2022-02-20 15:06:41,2022-02-20 15:06:41
"9ec4ba79-e751-4488-bd9a-cc01508c106c",3,17,-14,0.0357142857142857,9,8,17,"Positive","Sygehus ramt af strømafbrydelse (9ec4ba79-e751-4488-bd9a-cc01508c106c)",2022-02-11 14:54:20,2022-02-11 14:54:20
"9f2737a6-ad96-4d3a-8126-80aebda1cba1",15,28,-13,0.116279069767442,22,10,32,"Positive","Broafgiften på Storebæltsbroen kan være nøglen til en fast forbindelse over Kattegat (9f2737a6-ad96-4d3a-8126-80aebda1cba1)",2022-03-04 05:26:01,2022-03-04 05:26:01
"9f337a8c-23bc-43f4-af75-771d1a5ee5c1",35,42,-7,0.204678362573099,26,5,31,"Positive","Fynboer får svar: - Hvad har ukrainerne brug for, når de kommer til Fyn? (9f337a8c-23bc-43f4-af75-771d1a5ee5c1)",2022-03-03 17:24:57,2022-03-03 17:24:57
"9f9ecbc3-f77b-4fa8-a07c-699ec9751895",28,58,-30,0.16,41,21,62,"Positive","Fynsk kommune helt i bund: Knap hver tredje forlader folkeskolen uden brugbar eksamen (9f9ecbc3-f77b-4fa8-a07c-699ec9751895)",2022-01-18 12:16:49,2022-01-18 12:16:49
"a0022b64-2a2d-4121-82fd-590179bcacbc",1,35,-34,0.0078125,25,24,49,"Positive","Regler for isolation: Højt fravær af personale i dagtilbud - 21 procent hjemme (a0022b64-2a2d-4121-82fd-590179bcacbc)",2022-01-21 05:12:18,2022-01-21 05:12:18
"a00f2464-4989-4d72-b289-1e9260f1e4a0",-2,53,-55,-0.0170940170940171,32,32,64,"Negative","Dette billede af Gidsel gjorde ekspert bekymret (a00f2464-4989-4d72-b289-1e9260f1e4a0)",2022-01-16 10:12:10,2022-01-16 10:12:10
"a059d722-97a2-41f2-a941-06093ec5b3a1",34,42,-8,0.255639097744361,29,6,35,"Positive","Arkæologer er forbløffede over særligt fund i Aarup (a059d722-97a2-41f2-a941-06093ec5b3a1)",2022-03-18 11:09:49,2022-03-18 11:09:49
"a076bb83-0a0c-45a1-83f4-0ef31f4080c8",-10,15,-25,-0.104166666666667,10,19,29,"Negative","Overblik: Næsten alle restriktioner ophører - men det er ikke helt slut med coronapas og mundbind (a076bb83-0a0c-45a1-83f4-0ef31f4080c8)",2022-01-26 19:41:30,2022-01-26 19:41:30
"a08190c3-e943-4f96-b30e-38915c74eb1a",-13,5,-18,-0.185714285714286,5,10,15,"Negative","Præst sammenlignede læger med mordere og nazister - men hun mente det ikke (a08190c3-e943-4f96-b30e-38915c74eb1a)",2022-02-18 12:27:12,2022-02-18 12:27:12
"a0ab0cda-fb44-4b2c-85e8-4d9978816abb",11,30,-19,0.114583333333333,19,13,32,"Positive","OB er langt fra top-6-mål: - Det er nærmest slut nu (a0ab0cda-fb44-4b2c-85e8-4d9978816abb)",2022-02-21 06:45:26,2022-02-21 06:45:26
"a0f0dd98-0720-4c3f-b00b-cf9910611ab5",24,67,-43,0.12972972972973,39,30,69,"Positive","Axelsen i fjerde All England-finale i træk (a0f0dd98-0720-4c3f-b00b-cf9910611ab5)",2022-03-20 06:11:08,2022-03-20 06:11:08
"a10d3041-9e04-4e38-8786-675f291da2ec",2,60,-58,0.0127388535031847,39,27,66,"Positive","Tre røverier på en uge: Nu sætter butikker øget fokus på sikkerhed (a10d3041-9e04-4e38-8786-675f291da2ec)",2022-02-15 08:11:11,2022-02-15 08:11:11
"a12ab330-3ac9-4438-b3cd-48ee664ea221",40,58,-18,0.273972602739726,38,10,48,"Positive","Regnskab: Rekordoverskud i Middelfart Sparekase (a12ab330-3ac9-4438-b3cd-48ee664ea221)",2022-03-05 06:03:55,2022-03-05 06:03:55
"a12c2606-1cde-4c86-a2b2-a9280184d989",47,104,-57,0.169064748201439,58,39,97,"Positive","Er restriktionernes dage talte? - Vi savner det i den grad (a12c2606-1cde-4c86-a2b2-a9280184d989)",2022-01-18 19:56:31,2022-01-18 19:56:31
"a12f00dd-df2b-48ec-97da-b98e2775b3d7",-3,18,-21,-0.0245901639344262,16,14,30,"Negative","Russisk ballet udelukkes fra Odeon trods protester (a12f00dd-df2b-48ec-97da-b98e2775b3d7)",2022-02-27 11:32:18,2022-02-27 11:32:18
"a17cb048-717e-4491-bfa9-acb2760ea2a1",28,36,-8,0.254545454545455,26,6,32,"Positive","Nye uddannelser til Fyn: Aftale om udflytninger på plads (a17cb048-717e-4491-bfa9-acb2760ea2a1)",2022-03-22 08:24:12,2022-03-22 08:24:12
"a181304a-5106-4247-aaae-b3e644cbd6bb",11,23,-12,0.148648648648649,11,9,20,"Positive","Odense kommer tilbage på sejrskurs mod Skanderborg (a181304a-5106-4247-aaae-b3e644cbd6bb)",2022-01-21 19:22:42,2022-01-21 19:22:42
"a1953bc3-5fa8-4fd8-9142-093abc8abb57",23,59,-36,0.164285714285714,36,22,58,"Positive","Millioner på vej til fynske projekter: - Det er altafgørende (a1953bc3-5fa8-4fd8-9142-093abc8abb57)",2022-01-11 16:50:03,2022-01-11 16:50:03
"a1ba612b-2e7a-4d8a-95fd-542b651a422b",4,5,-1,0.0930232558139535,5,1,6,"Positive","Se videoen: Balletbørn danser til vildt lysshow på Egeskov Slot (a1ba612b-2e7a-4d8a-95fd-542b651a422b)",2022-02-14 20:00:24,2022-02-14 20:00:24
"a2446b16-a31c-4867-b26c-44f268ea4d0b",-2,26,-28,-0.0206185567010309,17,16,33,"Negative","Klintebjerg Efterskole blev sikret af lokale hænder (a2446b16-a31c-4867-b26c-44f268ea4d0b)",2022-01-30 19:06:41,2022-01-30 19:06:41
"a2d736ab-0d1c-45dd-b86e-93392635de1e",37,42,-5,0.345794392523364,24,3,27,"Positive","46 lyntest undersøgt: Hitraten spænder fra 2,5 til 94 procent (a2d736ab-0d1c-45dd-b86e-93392635de1e)",2022-02-16 10:45:58,2022-02-16 10:45:58
"a2d8183f-d476-445a-b5d9-3c4f757f8ec4",22,38,-16,0.196428571428571,28,8,36,"Positive","Reform skal give flere job: Blå partier afviser levertran i yoghurt i form af beløbsgrænse (a2d8183f-d476-445a-b5d9-3c4f757f8ec4)",2022-01-22 10:19:31,2022-01-22 10:19:31
"a33fc8a0-4029-497a-888a-476d0f2dc88d",27,50,-23,0.238938053097345,36,13,49,"Positive","Borgmester oplever større interesse for at bidrage til kystsikring (a33fc8a0-4029-497a-888a-476d0f2dc88d)",2022-01-10 08:06:16,2022-01-10 08:06:16
"a369742e-fc0b-4c5a-bbf6-7315aba10824",34,46,-12,0.274193548387097,30,6,36,"Positive","150 radiostationer spiller sang om fred for Ukraine (a369742e-fc0b-4c5a-bbf6-7315aba10824)",2022-03-04 06:24:40,2022-03-04 06:24:40
"a3ff17ba-464a-49f9-b0c8-d19ba9dc10d1",-24,7,-31,-0.521739130434783,5,14,19,"Negative","Fordobling af røverier i Odense: - Det lugter lidt af desperat behov for penge (a3ff17ba-464a-49f9-b0c8-d19ba9dc10d1)",2022-03-11 15:13:13,2022-03-11 15:13:13
"a40fbfc8-11d7-4a42-bd5d-6aac125b6ec8",4,34,-30,0.0341880341880342,21,24,45,"Positive","Er zoologisk have uetisk? Se fynboernes spørgsmål fra debat i Odense Zoo (a40fbfc8-11d7-4a42-bd5d-6aac125b6ec8)",2022-01-27 18:25:06,2022-01-27 18:25:06
"a412907e-d96a-4f91-88de-3bb60f163a6f",1,39,-38,0.0103092783505155,22,24,46,"Positive","Skuffet OB-anfører: Det føles som at have tabt (a412907e-d96a-4f91-88de-3bb60f163a6f)",2022-03-06 17:31:06,2022-03-06 17:31:06
"a47f95ae-8b79-41c0-9622-f301e5a68efb",-11,21,-32,-0.117021276595745,17,18,35,"Negative","Svend Lings selvmordsmanual bliver til forestilling i Operaen (a47f95ae-8b79-41c0-9622-f301e5a68efb)",2022-03-09 21:13:20,2022-03-09 21:13:20
"a4c443e0-769e-4a6f-9637-8021d970b9fa",71,81,-10,0.405714285714286,45,7,52,"Positive","FilmFyn triumferede ved Robert-priserne (a4c443e0-769e-4a6f-9637-8021d970b9fa)",2022-02-06 06:32:51,2022-02-06 06:32:51
"a4c4803a-1e6e-4967-8e0d-5a677090f312",25,50,-25,0.164473684210526,28,19,47,"Positive","Odense taber knebent til ungarsk mastodont (a4c4803a-1e6e-4967-8e0d-5a677090f312)",2022-01-23 17:48:06,2022-01-23 17:48:06
"a5740c17-e130-4a8b-8c8f-b77cc3260d44",20,72,-52,0.100502512562814,49,29,78,"Positive","Borgere frygter massivt svigt af handicappede - vil have kommune under tilsyn (a5740c17-e130-4a8b-8c8f-b77cc3260d44)",2022-01-25 20:31:15,2022-01-25 20:31:15
"a595af33-f56e-468e-8e1a-a9bc0aea38d2",-6,18,-24,-0.0645161290322581,13,19,32,"Negative","Odense Håndbold: Afslutter gruppespil med sikker sejr (a595af33-f56e-468e-8e1a-a9bc0aea38d2)",2022-02-20 17:11:46,2022-02-20 17:11:46
"a62c8277-b102-4e3e-a460-6b581dc166e9",-10,10,-20,-0.10989010989011,8,9,17,"Negative","Racisme-demonstration i Odense: - Alle mennesker er mennesker, uanset hvor de kommer fra (a62c8277-b102-4e3e-a460-6b581dc166e9)",2022-03-19 17:46:54,2022-03-19 17:46:54
"a650a459-eace-4b9e-ab1f-b1cb71f30cc4",10,17,-7,0.0943396226415094,13,5,18,"Positive","Markant hjørne under forvandling: Nu rives Skats gamle bygninger ned (a650a459-eace-4b9e-ab1f-b1cb71f30cc4)",2022-02-07 20:33:03,2022-02-07 20:33:03
"a669ca86-19a9-48d9-9b08-15dacc0e884b",-18,5,-23,-0.219512195121951,4,13,17,"Negative","To mænd idømt fire års fængsel - smuglede 900 kilo hash til Faaborg (a669ca86-19a9-48d9-9b08-15dacc0e884b)",2022-02-17 17:25:48,2022-02-17 17:25:48
"a671fe59-8f56-4b7a-ab01-0b3786f49c1e",13,39,-26,0.0783132530120482,31,16,47,"Positive","Tre kommuner sælger ud: Trækker nu penge ud af Rusland (a671fe59-8f56-4b7a-ab01-0b3786f49c1e)",2022-03-07 11:59:57,2022-03-07 11:59:57
"a70ae547-a5b2-4d12-8f66-3c8b2a69d539",11,38,-27,0.0990990990990991,21,21,42,"Positive","Bandeopgør: Sådan sikres akutmodtagelsen mod voldsmænd (a70ae547-a5b2-4d12-8f66-3c8b2a69d539)",2022-01-15 08:04:10,2022-01-15 08:04:10
"a70f24a9-26ac-4708-9e60-b267d08f0dfe",14,42,-28,0.106060606060606,27,16,43,"Positive","NU Festival udsolgt på få minutter: - Vi skulle sgu vise Lars Høgh, at vi laver en festival for ham (a70f24a9-26ac-4708-9e60-b267d08f0dfe)",2022-02-05 10:47:18,2022-02-05 10:47:18
"a7480ceb-9126-43f4-a5b3-08f4367257e7",1,26,-25,0.00869565217391304,22,19,41,"Positive","Fynsk virksomhed presset: Varmepumper er revet væk (a7480ceb-9126-43f4-a5b3-08f4367257e7)",2022-03-21 14:35:53,2022-03-21 14:35:53
"a75d52fb-7e9b-4f60-b0d1-2a911b79683c",19,30,-11,0.152,18,8,26,"Positive","Omdiskuteret Lars Høgh-trøje offentliggjort: Fans kommer foran i køen (a75d52fb-7e9b-4f60-b0d1-2a911b79683c)",2022-02-21 19:12:30,2022-02-21 19:12:30
"a822f4d3-ecc5-4788-b936-2460021e5aa3",44,57,-13,0.291390728476821,41,9,50,"Positive","Modstandere af fast forbindelse mellem Fyn og Als har fået nyt håb (a822f4d3-ecc5-4788-b936-2460021e5aa3)",2022-02-06 13:13:34,2022-02-06 13:13:34
"a8252188-8d93-481a-a488-023a16921147",-6,25,-31,-0.0545454545454545,18,16,34,"Negative","Hård kamp for GOG-stjernen: Gidsel bliver på hotellet under træning efter slag (a8252188-8d93-481a-a488-023a16921147)",2022-01-16 15:04:38,2022-01-16 15:04:38
"a85b9dd8-39fb-41e5-bef2-c90e0d4a85c1",5,37,-32,0.0304878048780488,29,20,49,"Positive","Minister opfordrer til at droppe russisk balletbesøg (a85b9dd8-39fb-41e5-bef2-c90e0d4a85c1)",2022-02-26 10:17:41,2022-02-26 10:17:41
"a87bc800-ccb8-44bc-9a9d-7251cfeacb02",4,11,-7,0.0540540540540541,7,5,12,"Positive","Efter fængselsdom: Bunkerchefs bestyrelsespost tages op til vurdering (a87bc800-ccb8-44bc-9a9d-7251cfeacb02)",2022-01-14 20:20:07,2022-01-14 20:20:07
"a91a4b36-e271-4202-8765-30bbe5b210b5",1,27,-26,0.00625,20,16,36,"Positive","Prop i systemet giver ukrainere ventetid på jobtilladelse (a91a4b36-e271-4202-8765-30bbe5b210b5)",2022-03-18 07:01:02,2022-03-18 07:01:02
"a92addd9-98fe-4966-b3bc-3886ebbf650d",12,20,-8,0.151898734177215,12,7,19,"Positive","Minut for minut: OB taber kamp om vigtige point (a92addd9-98fe-4966-b3bc-3886ebbf650d)",2022-03-20 13:20:03,2022-03-20 13:20:03
"a94d9774-b5e2-4db7-8f84-5711248a7ea4",-5,20,-25,-0.0381679389312977,17,17,34,"Negative","Fynsk vejstribefirma slipper for millionbøde for kartelaftaler (a94d9774-b5e2-4db7-8f84-5711248a7ea4)",2022-02-12 06:12:28,2022-02-12 06:12:28
"a96d514f-550b-406f-8c30-b88221994a6b",-8,24,-32,-0.0769230769230769,18,19,37,"Negative","Bager hæver priser på bagerbrød på grund af dyre elregninger (a96d514f-550b-406f-8c30-b88221994a6b)",2022-01-27 06:12:23,2022-01-27 06:12:23
"ac1975fb-8522-4a76-84ff-a70d88101f37",10,12,-2,0.0909090909090909,9,2,11,"Positive","Se optagelserne: Fem gange dronningen besøgte Fyn (ac1975fb-8522-4a76-84ff-a70d88101f37)",2022-01-14 18:44:19,2022-01-14 18:44:19
"ac1ed3e1-57e5-40a3-ba35-13487af81911",-2,15,-17,-0.0277777777777778,13,11,24,"Negative","Fem råd til de voksne: Sådan hjælper I de unge tilbage i fællesskabet (ac1ed3e1-57e5-40a3-ba35-13487af81911)",2022-02-01 20:08:14,2022-02-01 20:08:14
"ac5cc46d-7e38-40e1-8c35-b00f4fbb0b0e",-5,21,-26,-0.0442477876106195,17,17,34,"Negative","Parkeringssystem ved OUH: Datatilsynet kritiserer Region Syddanmark (ac5cc46d-7e38-40e1-8c35-b00f4fbb0b0e)",2022-01-17 19:36:42,2022-01-17 19:36:42
"ac64bcaa-c682-43eb-b787-237a0c564f7d",70,83,-13,0.368421052631579,56,11,67,"Positive","Ældrepleje: Erfaring fra fynske millioner bør rulles ud i hele landet (ac64bcaa-c682-43eb-b787-237a0c564f7d)",2022-02-17 09:10:36,2022-02-17 09:10:36
"acb81f18-1d9a-41ac-96cf-95b1b3b775cd",28,58,-30,0.135922330097087,44,21,65,"Positive","Medlemmer strømmer til Messerschmidts DF: Bjarne meldte sig ind i frokostpausen (acb81f18-1d9a-41ac-96cf-95b1b3b775cd)",2022-01-24 18:44:44,2022-01-24 18:44:44
"ace8fc1b-7ee5-4134-ba8a-ccf53b7538da",21,46,-25,0.116666666666667,27,18,45,"Positive","Dagligvarebutikker vil ændre loven: Borgere skal selv tilvælge tilbudsaviserne i postkassen (ace8fc1b-7ee5-4134-ba8a-ccf53b7538da)",2022-02-20 07:27:18,2022-02-20 07:27:18
"ad1bfceb-5ee1-4680-aa58-58e073158407",18,64,-46,0.113924050632911,35,33,68,"Positive","Spillesteder og barer glæder sig over udsigten til en normal hverdag: - Nu kan vi tjene vores egne penge igen (ad1bfceb-5ee1-4680-aa58-58e073158407)",2022-01-26 11:22:59,2022-01-26 11:22:59
"ada3e521-088a-4ce6-9228-95e5d4023d98",-1,22,-23,-0.00806451612903226,13,17,30,"Negative","11-årige Magnus har sovet i telt siden 2019 - nat nummer 900 var i selskab med stormen Malik (ada3e521-088a-4ce6-9228-95e5d4023d98)",2022-02-01 12:46:01,2022-02-01 12:46:01
"adcdbf94-8499-439e-ab7d-42278c4e16d4",52,61,-9,0.385185185185185,36,6,42,"Positive","Fynboer får svar: - Hvor skal vi henvende os, hvis vi kan have en familie boende? (adcdbf94-8499-439e-ab7d-42278c4e16d4)",2022-03-04 16:09:14,2022-03-04 16:09:14
"ade09754-dbd2-46ad-8f96-7c5231a891d7",40,56,-16,0.218579234972678,37,13,50,"Positive","Michael og Mikkel vil bygge kabelbane til vandsport - på land (ade09754-dbd2-46ad-8f96-7c5231a891d7)",2022-03-08 15:24:00,2022-03-08 06:15:11
"adf6a36c-f919-4d93-9bf2-deb8b51cb838",59,78,-19,0.302564102564103,48,13,61,"Positive","Sidy er Fyns 11. borgmester: - Først blev jeg helt tavs (adf6a36c-f919-4d93-9bf2-deb8b51cb838)",2022-02-03 17:47:06,2022-02-03 17:47:06
"ae013c8d-e2c4-4960-83fc-cd17064382da",36,55,-19,0.241610738255034,34,15,49,"Positive","To brødre slår verdensrekord efter 27 timers badmintonkamp (ae013c8d-e2c4-4960-83fc-cd17064382da)",2022-02-13 16:35:48,2022-02-13 16:35:48
"ae05c93a-55ed-43c4-a7ec-a97dcce04d90",25,45,-20,0.147058823529412,34,14,48,"Positive","Se tal for dit område: Tre gange om dagen kom ambulancen for sent på Fyn (ae05c93a-55ed-43c4-a7ec-a97dcce04d90)",2022-03-10 09:55:12,2022-03-10 09:55:12
"ae6477eb-8867-409a-95d0-9dc83998c92d",12,29,-17,0.0909090909090909,19,16,35,"Positive","Her kan du købe en hel halvø (ae6477eb-8867-409a-95d0-9dc83998c92d)",2022-02-14 10:38:04,2022-02-14 10:38:04
"ae9cf837-339d-4993-ac94-dfcf68637264",-1,30,-31,-0.0105263157894737,20,15,35,"Negative","Uddannelsesinstitution fyrer 22 medarbejdere - men skal ansætte igen senere (ae9cf837-339d-4993-ac94-dfcf68637264)",2022-02-15 16:13:00,2022-02-15 16:13:00
"aecc2714-65fc-4e5b-b77c-6d8b14db6892",7,37,-30,0.04375,25,23,48,"Positive","På store genåbningsdag har epidemien toppet (aecc2714-65fc-4e5b-b77c-6d8b14db6892)",2022-02-01 08:43:36,2022-02-01 08:43:36
"af7ef1b1-0a73-4357-9d65-a6c96ae38ce1",-22,14,-36,-0.213592233009709,9,22,31,"Negative","Pistolmand i Vollsmose slap for billigt: ""En meget beklagelig fejl"" (af7ef1b1-0a73-4357-9d65-a6c96ae38ce1)",2022-03-14 17:14:22,2022-03-14 17:14:22
"b01990fa-b4a7-45bc-87d1-7d966307b847",-8,20,-28,-0.073394495412844,17,22,39,"Negative","Rådmand vil droppe gasaftale: - Kunderne skal ikke betale for sanktioner mod Rusland (b01990fa-b4a7-45bc-87d1-7d966307b847)",2022-02-26 19:16:32,2022-02-26 19:16:32
"b056c194-329f-49be-88bf-47bc15391cc2",17,40,-23,0.114093959731544,24,16,40,"Positive","Smækfyldt med plastik: Havesakse og potteplanter ender i komposten (b056c194-329f-49be-88bf-47bc15391cc2)",2022-03-21 20:25:04,2022-03-21 20:25:04
"b0a07137-a310-45b1-8875-50500c0879e3",-3,22,-25,-0.0223880597014925,16,20,36,"Negative","Myndigheder ændrer snart anbefalingerne for coronaisolation (b0a07137-a310-45b1-8875-50500c0879e3)",2022-01-20 14:16:20,2022-01-20 14:16:20
"b0c0ae46-acc8-4d99-827c-f1aa887c4ec3",10,19,-9,0.0943396226415094,14,7,21,"Positive","Overblik: Disse coronarestriktioner ophører søndag (b0c0ae46-acc8-4d99-827c-f1aa887c4ec3)",2022-01-12 17:33:20,2022-01-12 17:33:20
"b12e5db3-05b4-429f-a798-e4fa176ac3d1",5,16,-11,0.0568181818181818,10,6,16,"Positive","Styrelse ser lille risiko for sundhedsskader i ny PFOS-sag (b12e5db3-05b4-429f-a798-e4fa176ac3d1)",2022-01-19 15:47:35,2022-01-19 15:47:35
"b158b2ee-efad-4dbc-8c9c-c8553ecb4ade",-32,18,-50,-0.258064516129032,17,28,45,"Negative","Fjerde gang på fem uger: Voldsom brand i gartneri (b158b2ee-efad-4dbc-8c9c-c8553ecb4ade)",2022-01-19 15:22:46,2022-01-19 15:22:46
"b16b1e0f-cefc-464b-a83c-cfeaa9382662",25,86,-61,0.102459016393443,61,41,102,"Positive","18-årige tjenere kritiserer Dok 5000: - Det er uhørt, siger fagforening (b16b1e0f-cefc-464b-a83c-cfeaa9382662)",2022-01-17 16:15:05,2022-01-17 16:15:05
"b19a2591-6e7c-497f-87fb-0e2e7b516d82",15,28,-13,0.12,21,6,27,"Positive","Danske stjerner optræder til støttekoncert for Ukraine (b19a2591-6e7c-497f-87fb-0e2e7b516d82)",2022-03-09 19:33:24,2022-03-09 19:33:24
"b1a4fd95-47c0-45f0-8a04-a4332cbff96e",4,10,-6,0.0727272727272727,9,3,12,"Positive","Kvindelig cyklist påkørt af varebil i færdselsuheld (b1a4fd95-47c0-45f0-8a04-a4332cbff96e)",2022-01-12 08:25:19,2022-01-12 08:25:19
"b1c37fff-6e41-4ed2-9b4f-5f362ec3baea",-7,19,-26,-0.0466666666666667,12,15,27,"Negative","Ung mand sigtet for trusler på livet efter skudepisode i Vollsmose (b1c37fff-6e41-4ed2-9b4f-5f362ec3baea)",2022-01-13 14:14:15,2022-01-13 14:14:15
"b1cd698b-322e-4e1a-aa99-f07c830cace2",3,48,-45,0.0141509433962264,36,30,66,"Positive","Konkursramt Windell-selskab lukker og slukker: Ingen penge til kreditorer (b1cd698b-322e-4e1a-aa99-f07c830cace2)",2022-02-21 11:30:00,2022-02-20 16:43:37
"b213fc2d-ed4a-4174-9c03-eb1001ebed71",14,34,-20,0.104477611940299,22,13,35,"Positive","Derfor er danske ukrainere tavse: - Rusland forsøger at påvirke folk på verdensplan, mener ekspert (b213fc2d-ed4a-4174-9c03-eb1001ebed71)",2022-02-25 12:34:36,2022-02-25 12:34:36
"b2276ede-48a1-46a2-ad08-6087c0881df6",-8,3,-11,-0.131147540983607,3,7,10,"Negative","Mand død i ulykke på Fynske Motorvej (b2276ede-48a1-46a2-ad08-6087c0881df6)",2022-02-03 06:39:00,2022-02-03 05:08:00
"b241d103-e909-402f-992f-2a7f2e5a3ad4",7,21,-14,0.0777777777777778,15,11,26,"Positive","Tirsdagens coronatal: Lille stigning i smitten (b241d103-e909-402f-992f-2a7f2e5a3ad4)",2022-02-01 14:16:22,2022-02-01 14:16:22
"b260ef91-c612-4f6d-9695-438a44ee41d6",18,29,-11,0.195652173913043,12,5,17,"Positive","Gidsel finder vej til All Star-hold ved EM (b260ef91-c612-4f6d-9695-438a44ee41d6)",2022-01-30 13:09:01,2022-01-30 13:09:01
"b2f0fd45-46e2-4501-9a2d-ef3221373880",22,36,-14,0.151724137931034,24,11,35,"Positive","Hurtigteststeder lukker senest 6. marts (b2f0fd45-46e2-4501-9a2d-ef3221373880)",2022-02-04 13:35:45,2022-02-04 13:35:45
"b2f408fc-d79f-48f4-821c-902c3c5d74fa",4,24,-20,0.032,14,17,31,"Positive","På jagt efter underskrifter: Bent vil have gratis bilture over Storebælt (b2f408fc-d79f-48f4-821c-902c3c5d74fa)",2022-02-09 09:36:32,2022-02-09 09:36:32
"b3024e9c-6d00-4827-b06e-dd7bec49439a",20,34,-14,0.172413793103448,17,14,31,"Positive","Odense sætter prop i CL-slinger med kanonstart mod Krim (b3024e9c-6d00-4827-b06e-dd7bec49439a)",2022-01-16 17:35:48,2022-01-16 17:35:48
"b37db079-aa2d-4cd8-9eb6-99b6e8ab8181",2,19,-17,0.0277777777777778,15,7,22,"Positive","Ikonisk popgruppe og internationale topnavne føjet til plakaten på Tinderbox (b37db079-aa2d-4cd8-9eb6-99b6e8ab8181)",2022-02-03 09:23:10,2022-02-03 09:23:10
"b401c848-0ce6-4009-bd69-baf894b3b308",-9,29,-38,-0.0604026845637584,21,21,42,"Negative","Muligt knivstikkeri: To kørt med politieskorte til OUH (b401c848-0ce6-4009-bd69-baf894b3b308)",2022-01-14 08:00:00,2022-01-14 07:22:41
"b41fd302-3960-47bb-900c-39b9ba2bd8f6",-3,27,-30,-0.027027027027027,20,19,39,"Negative","Vand trængte ind under mur - men beboere ånder lettet op (b41fd302-3960-47bb-900c-39b9ba2bd8f6)",2022-01-30 11:30:28,2022-01-30 11:30:28
"b41fd9cc-9994-4de4-8e7c-965e94d311b6",13,21,-8,0.152941176470588,14,6,20,"Positive","Christian Eriksen fik en time og lavede assist i første kamp (b41fd9cc-9994-4de4-8e7c-965e94d311b6)",2022-02-14 17:49:14,2022-02-14 17:49:14
"b451e5eb-61d1-4d13-b43a-e65c35ba496b",19,38,-19,0.143939393939394,29,16,45,"Positive","Aalborg-virksomhed vil gøre Lindø til grønt knudepunkt (b451e5eb-61d1-4d13-b43a-e65c35ba496b)",2022-01-11 05:55:51,2022-01-11 05:55:51
"b456eac3-fa57-429f-b14d-07f0713d292c",30,34,-4,0.280373831775701,16,2,18,"Positive","Tre prismodtagere føjes til HCA-familien i jubilæumsår (b456eac3-fa57-429f-b14d-07f0713d292c)",2022-03-02 10:21:29,2022-03-02 10:21:29
"b58cabdd-4e54-49b5-9a7e-26555ec8cd04",22,28,-6,0.239130434782609,18,5,23,"Positive","Regnskab: Trecifret millionoverskud hos fynsk reparationsværft (b58cabdd-4e54-49b5-9a7e-26555ec8cd04)",2022-02-23 20:48:59,2022-02-23 20:48:59
"b5a118a6-394c-48b9-bbfa-cb84b96252fe",3,15,-12,0.0517241379310345,11,6,17,"Positive","Fyn ramt af strømafbrydelser flere steder (b5a118a6-394c-48b9-bbfa-cb84b96252fe)",2022-01-24 20:20:58,2022-01-24 20:20:58
"b5a54740-e5a3-476b-b6b1-a84bc72009b7",-29,41,-70,-0.176829268292683,25,42,67,"Negative","Varevogn væltede på Storebæltsbroen - nu lægger Sund & Bælt sag an (b5a54740-e5a3-476b-b6b1-a84bc72009b7)",2022-01-18 17:24:52,2022-01-18 17:24:52
"b5eb0375-7497-453a-a6aa-df05812fec41",10,46,-36,0.0591715976331361,35,24,59,"Positive","Sexolog og underviser ser positivt på højt klamydiatal i Svendborg (b5eb0375-7497-453a-a6aa-df05812fec41)",2022-01-22 16:50:48,2022-01-22 16:50:48
"b601c0f1-a2e3-4a87-8520-0bbdb2017c57",-7,15,-22,-0.0843373493975904,12,11,23,"Negative","Hans måtte selv betale for vandskader efter storm - nu får han alligevel erstatning (b601c0f1-a2e3-4a87-8520-0bbdb2017c57)",2022-03-19 16:15:43,2022-03-19 16:15:43
"b6046860-0d2a-42d7-8c4d-6c9af8451f08",-52,9,-61,-0.547368421052632,9,30,39,"Negative","Seks unge dømt for groft overfald: Bankede jævnaldrende, filmede og delte voldshandlingen (b6046860-0d2a-42d7-8c4d-6c9af8451f08)",2022-02-10 09:14:35,2022-02-10 09:14:35
"b62b3d44-6d9b-4e04-8624-5567ff9767e8",8,13,-5,0.16,8,4,12,"Positive","Efter flot frostklar morgen: Husk paraplyen (b62b3d44-6d9b-4e04-8624-5567ff9767e8)",2022-01-21 05:43:59,2022-01-21 05:43:59
"b63ff6aa-b77c-41e8-af72-d2eb4c189ca0",-15,3,-18,-0.3,3,8,11,"Negative","Seneste nyt om stormen på Fyn: Kraftigste storm i fem år (b63ff6aa-b77c-41e8-af72-d2eb4c189ca0)",2022-02-18 22:11:00,2022-02-18 12:00:05
"b695594b-5abf-47c3-8e0d-46971b0e8218",-45,43,-88,-0.290322580645161,32,50,82,"Negative","Føler du, at krigen kommer for tæt på? Læs med her (b695594b-5abf-47c3-8e0d-46971b0e8218)",2022-03-12 07:37:29,2022-03-12 07:37:29
"b6b87853-4f1f-42b3-8399-fa729893b58e",5,27,-22,0.045045045045045,21,12,33,"Positive","Alkohol og samtykke: - Oftest er det ofrene, der ikke kan huske (b6b87853-4f1f-42b3-8399-fa729893b58e)",2022-02-11 17:33:07,2022-02-11 17:33:07
"b6cf2f78-9f5b-4325-8d86-2ac5603a2388",34,44,-10,0.261538461538462,29,6,35,"Positive","Første dag med dansk på skemaet: Ukrainske elever starter i fynsk skole (b6cf2f78-9f5b-4325-8d86-2ac5603a2388)",2022-03-21 18:59:49,2022-03-21 18:59:49
"b6d7d402-a47a-44b9-9126-2c64adf85ec6",6,14,-8,0.0769230769230769,12,4,16,"Positive","Alvorlig arbejdsulykke i Odense - Person svært tilskadekommen (b6d7d402-a47a-44b9-9126-2c64adf85ec6)",2022-03-21 19:41:00,2022-03-21 14:59:59
"b7045001-ef65-47e7-a8d9-c6555e805445",-5,2,-7,-0.0819672131147541,2,6,8,"Negative","Ukrainske flygtninge er ankommet til Odense (b7045001-ef65-47e7-a8d9-c6555e805445)",2022-03-04 06:41:00,2022-03-04 06:41:00
"b7714768-7ec9-4a53-9056-708046957a84",-10,13,-23,-0.0775193798449612,9,16,25,"Negative","Pumper klar til at sikre kældrene i Nyborgs midtby (b7714768-7ec9-4a53-9056-708046957a84)",2022-01-20 15:29:41,2022-01-20 15:29:41
"b774ae4e-6e07-4427-8703-3d1c0981a057",47,63,-16,0.303225806451613,37,13,50,"Positive","Idé til 350 millioner: Forslag vil lave friluftsbad om til kæmpe vandland (b774ae4e-6e07-4427-8703-3d1c0981a057)",2022-02-25 09:41:19,2022-02-25 09:41:19
"b7d7e8ff-9e4f-40ab-97b9-55a43d5b1769",11,39,-28,0.0558375634517767,29,17,46,"Positive","Rådmand om højspændingskabel: - Lejerne må søge hjælp i huslejenævnet (b7d7e8ff-9e4f-40ab-97b9-55a43d5b1769)",2022-02-21 20:31:00,2022-02-21 20:31:00
"b7f303e7-8d81-450f-a3cd-e1b9e5ef1925",57,67,-10,0.385135135135135,35,9,44,"Positive","- Eriksen gør ting, jeg aldrig har set før, siger holdkammerat (b7f303e7-8d81-450f-a3cd-e1b9e5ef1925)",2022-02-23 08:53:11,2022-02-23 08:53:11
"b83509de-5d50-43c6-a29c-3be0efa8ed88",24,39,-15,0.212389380530973,29,12,41,"Positive","Lokale gik sammen for at hjælpe - nu er lastbil fyldt med nødhjælp på vej til Ukraine (b83509de-5d50-43c6-a29c-3be0efa8ed88)",2022-03-08 09:09:41,2022-03-08 09:09:41
"b87d4acd-7800-4860-8a5d-58939665dc68",30,44,-14,0.1875,33,11,44,"Positive","Andreas og Emil vil sætte Svendborg på senneps-kortet (b87d4acd-7800-4860-8a5d-58939665dc68)",2022-01-24 05:27:36,2022-01-24 05:27:36
"b8e71cb4-6cb3-4567-be7f-114a5f2e6a4f",-7,13,-20,-0.0853658536585366,10,15,25,"Negative","Smittetallet på Fyn er det laveste i en måned (b8e71cb4-6cb3-4567-be7f-114a5f2e6a4f)",2022-02-24 14:24:13,2022-02-24 14:24:13
"b92ea5aa-cbdb-4e4c-8968-c51270d8ef5e",46,53,-7,0.343283582089552,30,5,35,"Positive","Ny curlinghal skal skabe fremtiden for sporten: - Jeg har ikke turde drømme med den is, vi har her (b92ea5aa-cbdb-4e4c-8968-c51270d8ef5e)",2022-02-15 20:25:59,2022-02-15 20:25:59
"b96034a9-b6da-4f6f-8b89-6fa76514aed0",25,30,-5,0.240384615384615,19,3,22,"Positive","Penge fra russisk fragtskib skal skabe glæde hos ukrainere i Assens (b96034a9-b6da-4f6f-8b89-6fa76514aed0)",2022-03-21 17:24:05,2022-03-21 17:24:05
"b9ad883a-dfb3-4a05-a4f5-7360b449c47e",2,7,-5,0.0363636363636364,4,2,6,"Positive","Flygtninge på vej til Fyn - se liveudsendelse fra bussen i Polen (b9ad883a-dfb3-4a05-a4f5-7360b449c47e)",2022-03-03 12:29:48,2022-03-03 12:29:48
"ba2221fc-84df-4e66-9622-613d562a95a8",8,10,-2,0.0909090909090909,8,2,10,"Positive","Se hele debatten: Hvilken forskel gør samtykkeloven? (ba2221fc-84df-4e66-9622-613d562a95a8)",2022-02-10 15:47:08,2022-02-10 15:47:08
"ba8d7e41-6d06-4b4a-b249-3fb1634dfe08",-6,10,-16,-0.0833333333333333,9,13,22,"Negative","Onsdagens coronatal: Smitten falder på Fyn (ba8d7e41-6d06-4b4a-b249-3fb1634dfe08)",2022-01-12 13:54:30,2022-01-12 13:54:30
"ba917c6a-2185-4780-87e7-48930732451f",2,33,-31,0.0143884892086331,20,20,40,"Positive","Ukrainske Galyna venter på familien i Nyborg: - Jeg glemmer aldrig den morgen (ba917c6a-2185-4780-87e7-48930732451f)",2022-03-01 09:06:43,2022-03-01 09:06:43
"bac3aec4-5324-4c46-b73e-ad8cca0d5ae5",-49,28,-77,-0.275280898876405,24,46,70,"Negative","Gartneri står over for milliondyr genopbygning: - Jeg synes jo bare, det er et trist syn (bac3aec4-5324-4c46-b73e-ad8cca0d5ae5)",2022-01-20 17:09:36,2022-01-20 17:09:36
"bb062e43-d6db-4005-aaae-3e08acd6a900",2,11,-9,0.0588235294117647,6,7,13,"Positive","Tåge bliver afløst af solskin (bb062e43-d6db-4005-aaae-3e08acd6a900)",2022-03-03 06:22:54,2022-03-03 06:22:54
"bb2711a9-0721-43c0-9924-d2e77757d646",-10,4,-14,-0.24390243902439,3,8,11,"Negative","Ko-kaos på motorvejen skabte lange køer (bb2711a9-0721-43c0-9924-d2e77757d646)",2022-01-27 19:51:00,2022-01-27 19:51:00
"bb2f4fd9-0c20-4a72-b03e-444ebc3208ff",24,39,-15,0.142857142857143,23,11,34,"Positive","Du bestemmer: Hvem skal have millioner til at forske i vigtige sygdomme? (bb2f4fd9-0c20-4a72-b03e-444ebc3208ff)",2022-02-08 17:39:13,2022-02-08 17:39:13
"bb93bedd-2724-4097-b4ef-5b6ab2ce57b1",13,39,-26,0.104838709677419,27,17,44,"Positive","Uniformer i hundredvis: Claus har samlet i mere end 30 år (bb93bedd-2724-4097-b4ef-5b6ab2ce57b1)",2022-01-23 09:44:47,2022-01-23 09:44:47
"bb9c8e2c-f92c-427e-a686-4f0ab8b76d55",17,29,-12,0.202380952380952,16,10,26,"Positive","Trods fint spil: OB tabte mod FCK (bb9c8e2c-f92c-427e-a686-4f0ab8b76d55)",2022-02-20 19:23:36,2022-02-20 19:23:36
"bbfad868-5bc1-44f8-a89e-5c4c1e8768e4",29,50,-21,0.159340659340659,29,15,44,"Positive","Coronaramt Bramsen: - Det har været en glæde og en ære at være forsvarsminister (bbfad868-5bc1-44f8-a89e-5c4c1e8768e4)",2022-02-04 11:11:52,2022-02-04 11:11:52
"bc0d33b8-6870-46c9-9c92-63c9df656a99",-7,3,-10,-0.166666666666667,3,5,8,"Negative","Person død efter drukneulykke (bc0d33b8-6870-46c9-9c92-63c9df656a99)",2022-03-08 13:21:54,2022-03-08 13:21:54
"bc5d1392-f89b-45c1-992f-8ce17682df1e",7,31,-24,0.07,18,14,32,"Positive","Gidsel er positivt overrasket over kroppens reaktion (bc5d1392-f89b-45c1-992f-8ce17682df1e)",2022-01-21 17:42:39,2022-01-21 17:42:39
"bca0c57d-33c2-4bd6-bc87-8ae3898c81bf",16,39,-23,0.113475177304965,29,14,43,"Positive","Fynboer får svar: Hvordan hjælper jeg bedst Ukraine? (bca0c57d-33c2-4bd6-bc87-8ae3898c81bf)",2022-03-11 19:25:00,2022-03-11 19:25:00
"bca7c9ee-a06c-4722-92b2-039744fc9f27",-21,4,-25,-0.259259259259259,4,15,19,"Negative","17-årig sigtet for røveriforsøg med køkkenkniv (bca7c9ee-a06c-4722-92b2-039744fc9f27)",2022-02-16 18:55:00,2022-02-16 18:55:00
"bccbc922-2ecc-400d-a532-01c571562520",-18,62,-80,-0.0636042402826855,43,46,89,"Negative","Benzinpriserne stiger voldsomt: - Det er fuldstændig sindssygt (bccbc922-2ecc-400d-a532-01c571562520)",2022-03-07 14:16:19,2022-03-07 14:16:19
"bccdbd4f-9feb-4256-91e4-36f25248fe16",3,9,-6,0.0612244897959184,6,4,10,"Positive","Tirsdag byder på regn og rusk (bccdbd4f-9feb-4256-91e4-36f25248fe16)",2022-02-01 05:56:25,2022-02-01 05:56:25
"bcd4629d-e8f2-4ef0-823a-b0bd79ad6028",-22,9,-31,-0.301369863013699,7,20,27,"Negative","DMI udvider varsel om vindstød af stormstyrke (bcd4629d-e8f2-4ef0-823a-b0bd79ad6028)",2022-02-16 10:13:47,2022-02-16 10:13:47
"bce6dd9c-8b0d-4575-b5b1-1aeef22b5c95",-3,38,-41,-0.0188679245283019,30,22,52,"Negative","Ingen boykot: Fynsk firma fortsætter i Rusland (bce6dd9c-8b0d-4575-b5b1-1aeef22b5c95)",2022-03-15 14:59:31,2022-03-15 14:59:31
"bd003a06-2116-47a8-817b-868c72fa3d04",-5,8,-13,-0.0806451612903226,6,7,13,"Negative","Yngre mand omkommet i færdselsuheld (bd003a06-2116-47a8-817b-868c72fa3d04)",2022-02-07 08:17:17,2022-02-07 08:17:17
"bd32f3c1-ec90-473f-a47e-cdc6be1a53d8",12,32,-20,0.105263157894737,22,11,33,"Positive","Flertal er imod, at præster kan nægte at vie homoseksuelle (bd32f3c1-ec90-473f-a47e-cdc6be1a53d8)",2022-02-13 07:04:06,2022-02-13 07:04:06
"bd34eab3-0275-4d9f-9d0f-6d529cec220e",-3,21,-24,-0.0211267605633803,16,22,38,"Negative","Tilbagebetalt halvanden gang: Derfor er der stadig afgift på Storebæltsbroen (bd34eab3-0275-4d9f-9d0f-6d529cec220e)",2022-03-18 16:03:19,2022-03-18 16:03:19
"bdb1fd5b-1f27-4b89-8646-910d63f9e781",3,16,-13,0.0333333333333333,11,10,21,"Positive","Se tal for dit sogn: Så mange er smittet den seneste uge (bdb1fd5b-1f27-4b89-8646-910d63f9e781)",2022-01-28 13:47:08,2022-01-28 13:47:08
"bdb30dc4-691c-4665-aec0-9963d0d0a464",-43,16,-59,-0.290540540540541,12,35,47,"Negative","Fynsk vognmandsfamilie har fået historisk stor millionbøde og fængselsstraf (bdb30dc4-691c-4665-aec0-9963d0d0a464)",2022-03-17 12:47:01,2022-03-17 12:47:01
"be302737-2cc0-42f0-8ea2-1b81f73e06f0",-14,14,-28,-0.130841121495327,8,23,31,"Negative","Derfor er dit vand fra vandhanen grønt (be302737-2cc0-42f0-8ea2-1b81f73e06f0)",2022-03-07 06:59:32,2022-03-07 06:59:32
"be3ac35b-2a85-46de-a4f3-ccc8eace1228",-12,34,-46,-0.0902255639097744,22,25,47,"Negative","Letbanen advarer: Her skal du passe på strømmen i letbanens køreledninger (be3ac35b-2a85-46de-a4f3-ccc8eace1228)",2022-01-25 16:57:54,2022-01-25 16:57:54
"beeeb01f-2b36-4854-9f8d-4eb32321d62a",25,38,-13,0.149700598802395,23,10,33,"Positive","Strynø kan blive Årets Ø: - Vi er 18 nationaliteter (beeeb01f-2b36-4854-9f8d-4eb32321d62a)",2022-02-22 20:14:14,2022-02-22 20:14:14
"bf0df549-8df6-4a68-b7b2-98738d3ddd86",18,29,-11,0.132352941176471,19,9,28,"Positive","Skal du betale eller have penge tilbage? Skat kimet ned på årets travleste uge (bf0df549-8df6-4a68-b7b2-98738d3ddd86)",2022-03-15 05:05:41,2022-03-15 05:05:41
"bf17e421-c8c1-4415-acf1-bf07b711df9b",2,12,-10,0.0285714285714286,11,8,19,"Positive","Fjerde vaccinestik på vej til særligt sårbare grupper (bf17e421-c8c1-4415-acf1-bf07b711df9b)",2022-01-12 17:35:11,2022-01-12 17:35:11
"bf28eeda-61f9-4372-afe4-042601c71998",8,31,-23,0.0930232558139535,17,18,35,"Positive","Skolechef om nedlagte restriktioner: Vi skal stadig passe på vores børn og unge (bf28eeda-61f9-4372-afe4-042601c71998)",2022-01-26 16:55:05,2022-01-26 16:55:05
"bf48ce95-9368-4bff-a7cd-5a0ebd65cd0d",20,34,-14,0.149253731343284,19,10,29,"Positive","Efter fire års kamp: Nævn freder 425 hektar natur vest for Odense (bf48ce95-9368-4bff-a7cd-5a0ebd65cd0d)",2022-01-19 11:22:14,2022-01-19 11:22:14
"bfb4f616-f048-44c0-8521-5b4f8050c524",39,58,-19,0.178899082568807,45,16,61,"Positive","Opladelige delebiler kan være på vej: Vil du dele en Tesla med din nabo? (bfb4f616-f048-44c0-8521-5b4f8050c524)",2022-01-24 20:08:58,2022-01-24 20:08:58
"c03a7b53-334a-43d3-bed8-00a03fd46287",-5,18,-23,-0.0390625,13,13,26,"Negative","Frosten forsvinder fra den danske vinter (c03a7b53-334a-43d3-bed8-00a03fd46287)",2022-03-01 08:37:09,2022-03-01 08:37:09
"c05af959-432f-41e9-8bd0-418fbff62653",11,24,-13,0.0733333333333333,18,12,30,"Positive","Nye affaldsbeholdere på vej i fynsk kommune: Tre skraldespande skal indeholde ti typer affald (c05af959-432f-41e9-8bd0-418fbff62653)",2022-02-07 09:36:07,2022-02-07 09:36:07
"c0addb9c-3976-4a72-85d5-9b29290d91be",17,20,-3,0.202380952380952,15,3,18,"Positive","Live: Sådan kan Fyn hjælpe Ukraine (c0addb9c-3976-4a72-85d5-9b29290d91be)",2022-03-03 16:00:07,2022-03-03 16:00:07
"c0c03582-3900-4c98-900d-99d483f3a222",32,56,-24,0.196319018404908,33,15,48,"Positive","Ukrainer overvældet af støtte: - Jeg vil gerne sige tak (c0c03582-3900-4c98-900d-99d483f3a222)",2022-03-04 12:11:03,2022-03-04 12:11:03
"c15a6c6f-9935-4709-bb5f-fdce33cb9a6e",10,14,-4,0.108695652173913,9,4,13,"Positive","Onsdag eftermiddag kan kultur-restriktioner være fortid (c15a6c6f-9935-4709-bb5f-fdce33cb9a6e)",2022-01-11 21:07:39,2022-01-11 21:07:39
"c19b1270-32f0-4208-b774-8dde5783f423",38,64,-26,0.26027397260274,41,17,58,"Positive","Skal du løbe 100 meter ekstra efter en hjertestarter, falder overlevelseschancerne betydeligt (c19b1270-32f0-4208-b774-8dde5783f423)",2022-01-19 05:15:24,2022-01-19 05:15:24
"c1a65fb1-cf63-48e0-baf2-49d9cb3001a9",19,21,-2,0.211111111111111,13,2,15,"Positive","Seer opfangede krofatters budskab: Ukrainske flygtninge på vej til Korinth Kro (c1a65fb1-cf63-48e0-baf2-49d9cb3001a9)",2022-02-28 20:47:25,2022-02-28 20:47:25
"c1cb08d6-dbb3-4a14-9ba3-30b16cb7cb10",-13,12,-25,-0.1625,8,17,25,"Negative","Kontakttallet falder - tyder på aftagende epidemi (c1cb08d6-dbb3-4a14-9ba3-30b16cb7cb10)",2022-02-22 13:06:39,2022-02-22 13:06:39
"c21584c0-1cc0-4d43-9292-ea9ba55cd284",-9,8,-17,-0.140625,7,14,21,"Negative","Mandagens coronatal: 30.000 fynboer er smittet på en uge (c21584c0-1cc0-4d43-9292-ea9ba55cd284)",2022-02-14 14:09:34,2022-02-14 14:09:34
"c24501b6-8839-4c20-b99e-e403e12cd820",25,36,-11,0.211864406779661,25,9,34,"Positive","SSI: Hver tredje sandsynligvis covid-smittet siden november (c24501b6-8839-4c20-b99e-e403e12cd820)",2022-02-03 12:26:01,2022-02-03 12:26:01
"c2e75fad-44d5-4fcf-8c68-c9d9f93e16fb",-20,12,-32,-0.227272727272727,9,18,27,"Negative","Stor betonklods placeret på vej: Mindreårig anholdt for at sætte andres liv og førlighed i fare (c2e75fad-44d5-4fcf-8c68-c9d9f93e16fb)",2022-01-12 09:13:20,2022-01-12 09:13:20
"c331e589-cdf2-4689-a3c9-15d72dc364a5",-8,14,-22,-0.106666666666667,10,17,27,"Negative","Lørdagens Coronatal: Nyt lille fald i smitten på Fyn (c331e589-cdf2-4689-a3c9-15d72dc364a5)",2022-02-05 14:01:49,2022-02-05 14:01:49
"c3d3f0bb-5089-416d-8f41-d14729d2dd30",41,52,-11,0.245508982035928,36,8,44,"Positive","Odenses børn skal tidligt prøve kræfter som fysikere (c3d3f0bb-5089-416d-8f41-d14729d2dd30)",2022-01-13 09:46:00,2022-01-13 09:46:00
"c4043829-3cb6-4860-8dc2-a0a0439bab72",28,37,-9,0.239316239316239,19,7,26,"Positive","OB gafler Søren Krogh i trænersøgende AaB (c4043829-3cb6-4860-8dc2-a0a0439bab72)",2022-01-18 09:25:30,2022-01-18 09:25:30
"c50c6e80-3f49-453d-9b5e-b7c339aefe86",39,97,-58,0.183098591549296,62,36,98,"Positive","Jagten på sosu'er er for alvor sat ind: - Vi mangler nogle kolleger (c50c6e80-3f49-453d-9b5e-b7c339aefe86)",2022-01-18 07:08:34,2022-01-18 07:08:34
"c51facd3-cfaf-4615-ae47-dac5dcf5974a",0,3,-3,0,2,3,5,"Negative","Der kan komme vindstød af kulingstyrke torsdag (c51facd3-cfaf-4615-ae47-dac5dcf5974a)",2022-01-20 05:48:19,2022-01-20 05:48:19
"c5ee86d5-ec40-48f5-88f9-e233f8386297",-5,46,-51,-0.0271739130434783,32,31,63,"Negative","Ekspert frygter nedrykning: - OB har et ekstremt lavt bundniveau (c5ee86d5-ec40-48f5-88f9-e233f8386297)",2022-03-22 09:39:05,2022-03-22 09:39:05
"c615629b-99ce-460a-a14b-0006998e52d6",40,60,-20,0.256410256410256,34,13,47,"Positive","Henrys hjerte gik i stå: Nu bliver hans kollegaer hædret (c615629b-99ce-460a-a14b-0006998e52d6)",2022-01-27 20:29:02,2022-01-27 20:29:02
"c685059c-f6e4-4767-94b1-e9e7f82a743f",6,14,-8,0.0967741935483871,8,5,13,"Positive","Se arrangementet: Stort støttearrangement for Ukraine i Odense (c685059c-f6e4-4767-94b1-e9e7f82a743f)",2022-03-04 15:00:00,2022-03-04 15:00:00
"c6de7bb5-0173-4358-9234-fd56cb3177d6",-10,26,-36,-0.0689655172413793,17,26,43,"Negative","Overlæge forudser udfordringer, når restriktioner ophører (c6de7bb5-0173-4358-9234-fd56cb3177d6)",2022-01-26 15:32:09,2022-01-26 15:32:09
"c7250bf8-07eb-4ca9-9a94-6e127c58bce6",8,41,-33,0.0625,30,20,50,"Positive","DGI står klar med leg og bevægelse for ukrainske flygtningebørn (c7250bf8-07eb-4ca9-9a94-6e127c58bce6)",2022-02-28 09:24:45,2022-02-28 09:24:45
"c7b00958-0d7b-4631-bc80-bc018893a96b",25,27,-2,0.390625,20,2,22,"Positive","Beredskab Fyn donerer redningsudstyr til Ukraine (c7b00958-0d7b-4631-bc80-bc018893a96b)",2022-03-07 10:52:48,2022-03-07 10:52:48
"c7b76ed5-6a98-4168-bfaf-9da397a3e440",8,12,-4,0.111111111111111,9,2,11,"Positive","Guldfeldt løb med guldet: Fynsk entreprenørfirma årets arbejdsplads (c7b76ed5-6a98-4168-bfaf-9da397a3e440)",2022-03-16 14:56:13,2022-03-16 14:56:13
"c7b9817c-219c-4611-bdca-4c75690b7e5f",13,26,-13,0.108333333333333,21,10,31,"Positive","Fire brandbiler fra Ringe skal slukke brande i Ukraine (c7b9817c-219c-4611-bdca-4c75690b7e5f)",2022-03-11 10:13:08,2022-03-11 10:13:08
"c835ceee-3439-43fd-860f-4bb696944739",-5,10,-15,-0.0675675675675676,7,10,17,"Negative","Se fynboernes billeder: Oversvømmelser overraskede lokale (c835ceee-3439-43fd-860f-4bb696944739)",2022-02-21 17:18:40,2022-02-21 17:18:40
"c8479ea3-3590-4f2e-9de6-6e9c3791728e",4,12,-8,0.0465116279069767,6,7,13,"Positive","Christian Eriksen udtaget til landsholdet (c8479ea3-3590-4f2e-9de6-6e9c3791728e)",2022-03-15 10:16:53,2022-03-15 10:16:53
"c88dd3e0-4d6c-443e-9bcc-e09adf2e0706",-43,144,-187,-0.0953436807095344,102,110,212,"Negative","Fynboerne får svar  om krigen: - Vinder Putin, må vi forvente en blodig borgerkrig (c88dd3e0-4d6c-443e-9bcc-e09adf2e0706)",2022-03-19 14:33:00,2022-03-09 21:12:08
"c897f24e-7a62-41cc-9aa8-520d73b9d69d",39,62,-23,0.261744966442953,37,12,49,"Positive","Efter formandsvalg: To fynske DF'ere overvejer at gå - en er meget tilfreds (c897f24e-7a62-41cc-9aa8-520d73b9d69d)",2022-01-23 19:12:35,2022-01-23 19:12:35
"c8c985e0-9646-45a7-8d74-560b3aa8616b",-9,8,-17,-0.132352941176471,6,11,17,"Negative","Ferietrafik: Se, hvilke tidsrum du skal undgå (c8c985e0-9646-45a7-8d74-560b3aa8616b)",2022-02-11 06:18:46,2022-02-11 06:18:46
"c8f6126a-f47b-4fc6-ae1a-726aa19e691b",26,54,-28,0.167741935483871,35,19,54,"Positive","Lærere i isolation giver udfordringer: Kommuner efterspørger mere selvbestemmelse (c8f6126a-f47b-4fc6-ae1a-726aa19e691b)",2022-01-20 20:56:07,2022-01-20 20:56:07
"c93ee62e-732b-4493-91ee-f47bdc211965",13,39,-26,0.08125,29,19,48,"Positive","A. P. Møller trækker stikket til Nyborg Slot: Træt af forsinkelser og fordyrelse af projekt (c93ee62e-732b-4493-91ee-f47bdc211965)",2022-02-08 14:11:19,2022-02-08 14:11:19
"c99e68fa-0d3e-4f71-a5e3-0b15d4a0536d",25,63,-38,0.125628140703518,38,32,70,"Positive","Nu siger Fyn farvel til restriktionerne: - Det er dejligt (c99e68fa-0d3e-4f71-a5e3-0b15d4a0536d)",2022-02-01 14:46:06,2022-02-01 14:46:06
"c9cb1d95-42ea-4770-8381-f2310889dba2",8,31,-23,0.0493827160493827,22,20,42,"Positive","Få svar på dit spørgsmål om energipriser på himmelflugt (c9cb1d95-42ea-4770-8381-f2310889dba2)",2022-01-19 20:25:39,2022-01-19 20:25:39
"ca05166f-40d3-41ec-b6e5-08423b1229d7",5,21,-16,0.0446428571428571,16,13,29,"Positive","Sadler om: Fjernvarme Fyn vil ikke sende gas-millioner til Rusland (ca05166f-40d3-41ec-b6e5-08423b1229d7)",2022-03-03 16:06:45,2022-03-03 16:06:45
"ca356c99-a9dc-4002-9a53-941c8591e04d",4,35,-31,0.0305343511450382,19,17,36,"Positive","OB taber til AaB: Fejl var afgørende (ca356c99-a9dc-4002-9a53-941c8591e04d)",2022-03-14 20:04:00,2022-03-14 20:04:00
"ca9231df-5aec-44cd-bab3-8f0be2199741",8,25,-17,0.062992125984252,18,10,28,"Positive","Rapport fastslår: Odense Fjord kan blive ramt af vandsstigninger (ca9231df-5aec-44cd-bab3-8f0be2199741)",2022-02-06 14:00:24,2022-02-06 14:00:24
"cac83813-6010-4de4-b724-cfce4fa12721",0,6,-6,0,6,5,11,"Negative","Slibearbejde på letbaneskinnerne vil støje i aftentimerne (cac83813-6010-4de4-b724-cfce4fa12721)",2022-02-02 19:05:12,2022-02-02 19:05:12
"caf4ccef-a4e9-45f5-b404-9ac0bae453b0",-8,28,-36,-0.0421052631578947,22,25,47,"Negative","Se alle de gamle billeder: Sådan har friluftsbadet i Odense udviklet sig på et århundrede (caf4ccef-a4e9-45f5-b404-9ac0bae453b0)",2022-02-23 17:02:04,2022-02-23 17:02:04
"cb0468de-9395-48c2-85ee-b084173d27d9",13,34,-21,0.0755813953488372,27,16,43,"Positive","Skal Storebæltsbroen være gratis? Se, hvad partierne mener (cb0468de-9395-48c2-85ee-b084173d27d9)",2022-03-20 12:43:00,2022-03-16 16:55:33
"cb47127b-7472-4261-8d21-2e78021071c4",5,17,-12,0.0714285714285714,11,9,20,"Positive","Odense Zoo har fået en lille, ny dyreunge (cb47127b-7472-4261-8d21-2e78021071c4)",2022-01-19 08:01:13,2022-01-19 08:01:13
"cb5a716c-8740-4a60-bfab-e3fd5d5a909b",21,27,-6,0.155555555555556,20,5,25,"Positive","Nyt journalsystem på fynske sygehuse - 14.000 medarbejdere i oplæring (cb5a716c-8740-4a60-bfab-e3fd5d5a909b)",2022-02-20 12:08:56,2022-02-20 12:08:56
"cb9c4b15-b39e-4179-af7c-52f6bb15dcd8",-6,9,-15,-0.0857142857142857,5,10,15,"Negative","Tirsdagen byder på koldt vejr - giver risiko for glatte veje (cb9c4b15-b39e-4179-af7c-52f6bb15dcd8)",2022-02-22 05:40:44,2022-02-22 05:40:44
"cbd3828e-de29-4693-8dac-2b617146fbdf",11,42,-31,0.123595505617978,22,14,36,"Positive","Ødelagt korsbånd: Gidsel har måske spillet sin sidste kamp for GOG (cbd3828e-de29-4693-8dac-2b617146fbdf)",2022-02-01 14:05:22,2022-02-01 14:05:22
"cbd7ef60-abe5-48ce-9068-46b48ca84939",-3,10,-13,-0.0447761194029851,4,11,15,"Negative","Torsdagens vejr bliver en våd og grå fornøjelse (cbd7ef60-abe5-48ce-9068-46b48ca84939)",2022-02-24 05:57:50,2022-02-24 05:57:50
"cc1ad294-0ecc-4e1b-b035-2124cf52ab17",44,77,-33,0.227979274611399,58,21,79,"Positive","Minister kritiseres for at trække Nyborg-projekt i langdrag: - Jeg kunne ikke have prioriteret det højere (cc1ad294-0ecc-4e1b-b035-2124cf52ab17)",2022-02-08 17:43:45,2022-02-08 17:43:45
"cd44483d-0c36-4a90-a67e-2bfa9da454dd",40,59,-19,0.28169014084507,40,12,52,"Positive","Fynsk Erhverv: Reformpakke tilfører ikke arbejdskraft nu og her (cd44483d-0c36-4a90-a67e-2bfa9da454dd)",2022-01-22 09:44:25,2022-01-22 09:44:25
"ce00a52d-4449-4d8a-b9ce-260218f8571c",-7,13,-20,-0.0654205607476635,11,17,28,"Negative","Smittetallene på Fyn tager et hop - største stigning hidtil (ce00a52d-4449-4d8a-b9ce-260218f8571c)",2022-02-10 14:16:52,2022-02-10 14:16:52
"ce3f0e19-7476-44b8-a69b-a6d9b4097fff",1,13,-12,0.0147058823529412,11,6,17,"Positive","DBU har fundet Lars Høghs afløser (ce3f0e19-7476-44b8-a69b-a6d9b4097fff)",2022-03-14 13:00:13,2022-03-14 13:00:13
"cec82981-e202-4206-bb1a-6090fe4d5e05",-4,6,-10,-0.0412371134020619,4,9,13,"Negative","Jagt gennem Odense: Politi fangede to mænd på knallert med stoffer og stort pengebeløb (cec82981-e202-4206-bb1a-6090fe4d5e05)",2022-02-04 21:38:35,2022-02-04 21:38:35
"cf6eb29b-dd21-40c6-9d59-e783a36d4a14",0,11,-11,0,9,6,15,"Negative","Se hele debatten: Var det en fejl at lukke skolerne under coronapandemien? (cf6eb29b-dd21-40c6-9d59-e783a36d4a14)",2022-02-03 17:00:00,2022-02-03 15:45:10
"d016e36c-163c-4a83-9564-1d8b8d255d1e",45,62,-17,0.304054054054054,40,10,50,"Positive","Fynske virksomheder er klar til ukrainsk arbejdskraft (d016e36c-163c-4a83-9564-1d8b8d255d1e)",2022-03-17 16:36:08,2022-03-17 16:36:08
"d0305e39-75c9-4140-a17a-4958461a00fb",-17,57,-74,-0.0711297071129707,41,44,85,"Negative","Rock Under Broen: Aerosmith aflyser turné - kommer ikke til Fyn alligevel (d0305e39-75c9-4140-a17a-4958461a00fb)",2022-01-31 18:33:24,2022-01-31 18:33:24
"d052fd0f-d4c8-4b64-b3a1-a60dbe4aea49",32,58,-26,0.223776223776224,33,17,50,"Positive","Matias blev pacet mod gymnasiet - men tog sit 'livs bedste valg' (d052fd0f-d4c8-4b64-b3a1-a60dbe4aea49)",2022-03-01 16:05:47,2022-03-01 16:05:47
"d080bffb-dc13-444f-8882-d3d41c33a385",20,51,-31,0.111731843575419,37,17,54,"Positive","Fynsk DF-profil: Pia er blevet for gammel (d080bffb-dc13-444f-8882-d3d41c33a385)",2022-01-21 14:12:30,2022-01-21 14:12:30
"d16a31fe-2f9b-4b09-88c1-030e3e07d2c7",0,19,-19,0,13,12,25,"Negative","Modstander meget provokeret af disse billeder af Odense Håndbold: - De står og griner (d16a31fe-2f9b-4b09-88c1-030e3e07d2c7)",2022-02-23 12:12:08,2022-02-23 12:12:08
"d1bbb9e3-0d12-43b2-b930-7238a1c9f578",-21,19,-40,-0.189189189189189,17,21,38,"Negative","Ti fængslet efter knivoverfald (d1bbb9e3-0d12-43b2-b930-7238a1c9f578)",2022-03-02 13:36:31,2022-03-02 13:36:31
"d2008dcf-2103-4bd0-afce-a1c7758f9088",-1,14,-15,-0.0117647058823529,11,13,24,"Negative","Mandagens coronatal: Næsten 1.000 flere fynboer er smittede (d2008dcf-2103-4bd0-afce-a1c7758f9088)",2022-01-17 13:55:14,2022-01-17 13:55:14
"d232f6db-4ace-45c9-9e83-15313ebd5135",0,9,-9,0,5,6,11,"Negative","Kølig torsdag med mulighed for sol (d232f6db-4ace-45c9-9e83-15313ebd5135)",2022-02-10 05:41:48,2022-02-10 05:41:48
"d28172bc-3f92-4ff4-a016-37b105dc9af6",46,69,-23,0.270588235294118,42,14,56,"Positive","Trodser corona: Rekordmange feriegæster besøger Fyn (d28172bc-3f92-4ff4-a016-37b105dc9af6)",2022-02-10 15:22:30,2022-02-10 15:22:30
"d2899b10-ec43-4f69-ab64-eb1cd5c300bd",34,52,-18,0.257575757575758,30,17,47,"Positive","Studerende glade for genåbning: - Jeg glæder mig til at lære mine medstuderende at kende (d2899b10-ec43-4f69-ab64-eb1cd5c300bd)",2022-02-01 13:06:14,2022-02-01 13:06:14
"d2a36e2b-fc80-41b2-b890-5eea3c8d4b13",45,78,-33,0.236842105263158,51,22,73,"Positive","DF-profil genopstiller: Alex Ahrendtsen har genfundet lysten til politik (d2a36e2b-fc80-41b2-b890-5eea3c8d4b13)",2022-02-11 16:00:09,2022-02-11 16:00:09
"d2c87003-4f5d-43ac-9ce1-b73b5d5164c4",-4,5,-9,-0.0416666666666667,5,6,11,"Negative","Religionshistoriker efter debat om vielser: Vers i Bibelen handler som sådan ikke om homoseksualitet (d2c87003-4f5d-43ac-9ce1-b73b5d5164c4)",2022-02-08 18:25:08,2022-02-08 18:25:08
"d2d98cbc-e696-40b9-a85c-54743a6fb79f",13,22,-9,0.1015625,16,8,24,"Positive","Ændret familiemønster: Tusindvis flere singlehusstande siden 2018 (d2d98cbc-e696-40b9-a85c-54743a6fb79f)",2022-02-14 19:04:52,2022-02-14 19:04:52
"d317510b-dd6f-43f9-88fc-15ee767fa3fb",-10,15,-25,-0.0819672131147541,10,14,24,"Negative","Jens Galschiøt opstiller skamstøtte i Budapest (d317510b-dd6f-43f9-88fc-15ee767fa3fb)",2022-03-02 12:14:19,2022-03-02 12:14:19
"d345934d-e477-4b32-a6a7-6de6a7714439",23,52,-29,0.169117647058824,34,19,53,"Positive","Folketinget samles for at diskutere stigende energipriser: - Det er en alvorlig situation (d345934d-e477-4b32-a6a7-6de6a7714439)",2022-01-18 05:14:01,2022-01-18 05:14:01
"d3faaf40-7de5-41ed-bbf0-d90fa7c5d79d",1,11,-10,0.0166666666666667,7,8,15,"Positive","Blæsende weekend i vente: Fredag starter med regn og slutter med vind (d3faaf40-7de5-41ed-bbf0-d90fa7c5d79d)",2022-02-04 05:30:33,2022-02-04 05:30:33
"d53146a0-2b57-4347-b897-2262ab6cd117",10,84,-74,0.0427350427350427,51,45,96,"Positive","Markant færre vil læse til sygeplejerske i Odense: - Det er katastrofalt (d53146a0-2b57-4347-b897-2262ab6cd117)",2022-03-16 14:29:24,2022-03-16 14:29:24
"d53a1af8-c835-43e1-a4ff-b702d23a5fd3",28,30,-2,0.269230769230769,19,2,21,"Positive","El-bilisterne på Fynske Motorvej får flere ladere inden jul (d53a1af8-c835-43e1-a4ff-b702d23a5fd3)",2022-01-27 09:08:23,2022-01-27 09:08:23
"d561dae2-2da8-454b-b76a-e16b6dfb4b66",5,15,-10,0.0694444444444444,8,6,14,"Positive","Her er beviset: Er forår også på vej til dig? (d561dae2-2da8-454b-b76a-e16b6dfb4b66)",2022-01-18 06:01:32,2022-01-18 06:01:32
"d5a4b7c9-7b22-4d26-800a-1d3bbc77d677",3,11,-8,0.0681818181818182,5,7,12,"Positive","Vejret: Kølig dag i vente (d5a4b7c9-7b22-4d26-800a-1d3bbc77d677)",2022-02-08 06:22:04,2022-02-08 06:22:04
"d5ca14ef-01ac-469f-a3b1-523e6c4b9f1a",17,22,-5,0.182795698924731,13,4,17,"Positive","Første spadestik til Fremtidens Forstad: - Det er en stor milepæl i byudviklingen (d5ca14ef-01ac-469f-a3b1-523e6c4b9f1a)",2022-02-04 20:08:02,2022-02-04 20:08:02
"d5d6383b-b992-45a2-b9b5-4eb197295fe6",9,17,-8,0.136363636363636,12,5,17,"Positive","Nu kan børn blive testet på alle regionens teststeder (d5d6383b-b992-45a2-b9b5-4eb197295fe6)",2022-01-10 09:11:10,2022-01-10 09:11:10
"d5de9adf-d010-4e2e-8e8a-90d41c47d37c",38,44,-6,0.351851851851852,24,6,30,"Positive","Landmænd fik nej til realkreditlån: Nu har private lånt dem en million (d5de9adf-d010-4e2e-8e8a-90d41c47d37c)",2022-02-17 16:35:12,2022-02-17 16:35:12
"d5e1fe28-b17c-4e3b-b985-dc23a5b282d8",10,35,-25,0.0684931506849315,25,15,40,"Positive","Lokalredaktør om asylcenter på Langeland: - Langelænderne er meget, meget positive (d5e1fe28-b17c-4e3b-b985-dc23a5b282d8)",2022-03-11 17:45:59,2022-03-11 17:45:59
"d629fa3d-5941-49b1-933d-65c70e5d84a2",34,35,-1,0.435897435897436,21,1,22,"Positive","Viktor Axelsen høster endnu en pris (d629fa3d-5941-49b1-933d-65c70e5d84a2)",2022-02-12 16:59:44,2022-02-12 16:59:44
"d675377d-5282-472c-960b-78494bb92f51",52,57,-5,0.472727272727273,28,4,32,"Positive","Stor fynsk cykelsommer i vente: Danmark Rundt kører to etaper på fynske landeveje (d675377d-5282-472c-960b-78494bb92f51)",2022-02-24 13:38:32,2022-02-24 13:38:32
"d6cd3bff-b0ff-47b9-aaa2-0b7af53c785f",32,39,-7,0.288288288288288,21,6,27,"Positive","Heindahl forlader russisk klub øjeblikkeligt (d6cd3bff-b0ff-47b9-aaa2-0b7af53c785f)",2022-03-03 10:48:39,2022-03-03 10:48:39
"d6d29dfc-7201-4f9e-89cd-bf0a48b2a843",92,120,-28,0.366533864541833,76,14,90,"Positive","Ole Frank Rasmussen bliver redaktør for stor og samlet nyhedsredaktion på TV 2 Fyn (d6d29dfc-7201-4f9e-89cd-bf0a48b2a843)",2022-02-04 14:44:52,2022-02-04 14:44:52
"d6e6c2b3-21a8-45b5-abca-3a56bf632c02",-21,32,-53,-0.11864406779661,23,32,55,"Negative","Svindlere gik efter Else, Esther, Herdis og andre kvinder (d6e6c2b3-21a8-45b5-abca-3a56bf632c02)",2022-01-20 13:30:03,2022-01-20 13:30:03
"d769f14b-8a21-4567-8c70-d1fae41d3823",-19,13,-32,-0.283582089552239,9,13,22,"Negative","Efter stormen Malik: Fyn ramt af stormflod flere steder (d769f14b-8a21-4567-8c70-d1fae41d3823)",2022-01-31 13:17:25,2022-01-31 13:17:25
"d795e184-6aaf-41ee-ad9c-1ba1e6672e29",-2,13,-15,-0.0227272727272727,10,11,21,"Negative","De næste timer styrtdykker strømprisen - her bliver den næsten gratis (d795e184-6aaf-41ee-ad9c-1ba1e6672e29)",2022-03-11 11:15:59,2022-03-11 11:15:59
"d80e4df5-9c46-413a-b753-78d736887f5f",1,6,-5,0.0149253731343284,4,3,7,"Positive","Nye regler i Polen: Registrerede flygtninge kan ikke komme med bussen til Fyn (d80e4df5-9c46-413a-b753-78d736887f5f)",2022-03-02 15:58:39,2022-03-02 15:58:39
"d8162c3f-aec9-4042-9baf-b9d3e10148eb",16,126,-110,0.0350109409190372,96,66,162,"Positive","Kommune undlod at gribe ind: Intetanende lejere sover klos op ad højspændingskabel (d8162c3f-aec9-4042-9baf-b9d3e10148eb)",2022-02-20 08:58:55,2022-02-20 08:58:55
"d8800657-4f73-41d4-b277-b7b30c93ca5d",-10,30,-40,-0.072992700729927,23,24,47,"Negative","Borgmester efterspørger sanktioner: Russiske fragtskibe kan frit anløbe i Assens Havn (d8800657-4f73-41d4-b277-b7b30c93ca5d)",2022-03-09 18:01:05,2022-03-09 18:01:05
"d9279f05-6e65-4860-8ed8-6fd3d10c725d",18,35,-17,0.155172413793103,24,12,36,"Positive","OB's fodbolddirektør: Ændring af organisationen er nødvendig (d9279f05-6e65-4860-8ed8-6fd3d10c725d)",2022-03-02 06:03:47,2022-03-02 06:03:47
"d9773102-8af6-44e1-847f-fe6a0b28639d",21,30,-9,0.241379310344828,20,5,25,"Positive","'Superlykkeligt' kulturliv ser frem til genåbning på mandag (d9773102-8af6-44e1-847f-fe6a0b28639d)",2022-01-11 19:55:56,2022-01-11 19:55:56
"da02336b-4bdd-472f-8a25-389d39f32dff",79,153,-74,0.233727810650888,109,43,152,"Positive","Fynsk virksomhed angrebet af russiske hackere – eksperter varsler flere cyberangreb (da02336b-4bdd-472f-8a25-389d39f32dff)",2022-03-02 14:48:25,2022-03-02 14:48:25
"dad07e52-a710-4552-b5c1-0a9cc3254085",6,19,-13,0.0967741935483871,14,10,24,"Positive","Sundhedsstyrelsen: Nu kan du afbryde selvisolation tidligere (dad07e52-a710-4552-b5c1-0a9cc3254085)",2022-01-24 13:41:54,2022-01-24 13:41:54
"db05222f-0817-442e-8951-50fecbf1e5a2",37,63,-26,0.152892561983471,49,19,68,"Positive","Klassisk museumsformidling eller virtual reality: Slotsprojekt i Nyborg skaber historisk uenighed (db05222f-0817-442e-8951-50fecbf1e5a2)",2022-02-23 17:55:14,2022-02-23 17:55:14
"db10e1c1-5145-43be-a874-06397a8e5562",-9,8,-17,-0.157894736842105,7,11,18,"Negative","Kontakttallet er 0,9 - tyder på svagt aftagende epidemi (db10e1c1-5145-43be-a874-06397a8e5562)",2022-02-15 12:36:27,2022-02-15 12:36:27
"db489abb-c97c-4ca6-af50-771bd56bd683",-11,4,-15,-0.211538461538462,3,9,12,"Negative","Flere færgeafgange aflyses på grund af kraftig blæst (db489abb-c97c-4ca6-af50-771bd56bd683)",2022-02-16 17:40:59,2022-02-16 17:40:59
"db87180c-9e1f-45cf-a299-2cf2d03b775b",56,71,-15,0.421052631578947,41,13,54,"Positive","Røde Kors åbner værksted: Ole giver gamle ting nyt liv (db87180c-9e1f-45cf-a299-2cf2d03b775b)",2022-01-26 05:20:56,2022-01-26 05:20:56
"dba0856d-b8c2-4916-8f21-208b6ccdb018",-8,33,-41,-0.0509554140127389,23,26,49,"Negative","Fiskeriflaget er på halv i Bagenkop: - Det er en sorgens dag (dba0856d-b8c2-4916-8f21-208b6ccdb018)",2022-01-15 15:51:56,2022-01-15 15:51:56
"dba1b90b-5b38-40a6-9515-4609cf3604b4",-21,61,-82,-0.112903225806452,42,55,97,"Negative","Når stormen kommer: Dit træ er dit ansvar - hvad kan du gøre? (dba1b90b-5b38-40a6-9515-4609cf3604b4)",2022-02-18 15:01:12,2022-02-18 15:01:12
"dbe5344a-669a-438c-bc75-f4124ef73d02",17,36,-19,0.114864864864865,26,11,37,"Positive","Troels er klar til at huse ukrainske flygtninge: - Det mest frygtelige, jeg kender, er krig (dbe5344a-669a-438c-bc75-f4124ef73d02)",2022-03-02 21:18:19,2022-03-02 21:18:19
"dbfb8dbb-6852-4088-a2b4-2aa49ede656e",3,49,-46,0.0236220472440945,26,21,47,"Positive","- Det burde ikke kunne lade sig gøre, siger forbløffet ekspert om Gidsel-tal (dbfb8dbb-6852-4088-a2b4-2aa49ede656e)",2022-01-17 08:32:56,2022-01-17 08:32:56
"dcd328e4-9ca0-4c06-b561-aee7f39a5908",-1,18,-19,-0.0103092783505155,13,13,26,"Negative","TV 2 erfarer: Regeringen vil forbyde salg af tobak for bestemte årgange (dcd328e4-9ca0-4c06-b561-aee7f39a5908)",2022-03-15 07:50:55,2022-03-15 07:50:55
"dd6586d2-c4ba-4885-b530-0c08736d83d0",49,60,-11,0.408333333333333,30,7,37,"Positive","Stjerneguitarist skal undervise på Sydfyn (dd6586d2-c4ba-4885-b530-0c08736d83d0)",2022-01-12 20:31:08,2022-01-12 20:31:08
"dd813f53-2102-4d01-b569-32bb1b93ac68",20,46,-26,0.134228187919463,29,18,47,"Positive","Bo ønsker flere internationale navne på festival - corona udfordrer (dd813f53-2102-4d01-b569-32bb1b93ac68)",2022-02-06 11:16:19,2022-02-06 11:16:19
"de187543-f897-4bf9-b60a-376db68fa37a",-18,19,-37,-0.144,14,22,36,"Negative","Politiet om stigende antal ulykker på elløbehjul: - Vi kan se, at tendensen fortsætter (de187543-f897-4bf9-b60a-376db68fa37a)",2022-02-23 20:04:05,2022-02-23 20:04:05
"de70b7a3-64dd-4ae9-8570-5d9ef09cd697",11,16,-5,0.183333333333333,10,4,14,"Positive","Lørdagen bliver grå - men med en solrig eftermiddag (de70b7a3-64dd-4ae9-8570-5d9ef09cd697)",2022-02-05 06:44:38,2022-02-05 06:44:38
"de9b8493-93ce-466b-ab13-21d439d292f3",9,34,-25,0.0703125,21,17,38,"Positive","GOG slår drilske russere og sikrer avancement (de9b8493-93ce-466b-ab13-21d439d292f3)",2022-02-16 06:53:35,2022-02-16 06:53:35
"deb93341-cc71-4928-832d-ee612c2d9a0a",-21,17,-38,-0.177966101694915,13,22,35,"Negative","Lanas far er fanget i Ukraine: - Vi beder Gud om, at det skal ske hurtigt, hvis det skal ske (deb93341-cc71-4928-832d-ee612c2d9a0a)",2022-03-02 14:12:32,2022-03-02 14:12:32
"dec685a0-2d8b-488b-b179-d66ae49b0e95",29,40,-11,0.223076923076923,23,7,30,"Positive","Ukrainerloven skaber travlhed hos borgerservice: - Det er nøglen til en almindelig hverdag i Danmark (dec685a0-2d8b-488b-b179-d66ae49b0e95)",2022-03-17 14:53:10,2022-03-17 14:53:10
"ded0ac5d-3486-4b54-a39b-6240f29024a5",-4,51,-55,-0.0158730158730159,42,33,75,"Negative","Sandie fik tvangsfjernet sine børn af kommunen: Socialrådgiver er rystet og kalder det for lovbrud (ded0ac5d-3486-4b54-a39b-6240f29024a5)",2022-03-18 19:21:41,2022-03-18 19:21:41
"ded74e77-07c2-4764-b589-25b114ce1579",24,55,-31,0.11214953271028,41,19,60,"Positive","Kontrakt med i seng? Flere fynske unge siger, at de ikke ved nok om samtykke under sex (ded74e77-07c2-4764-b589-25b114ce1579)",2022-02-09 10:45:07,2022-02-09 10:45:07
"df03daa0-8185-4715-a30d-4482e66086ee",26,71,-45,0.0921985815602837,50,33,83,"Positive","Atomaffald spøger igen: - Sandsynligheden for at støde på forhindringer er mindre på Fyn (df03daa0-8185-4715-a30d-4482e66086ee)",2022-01-21 11:33:48,2022-01-21 11:33:48
"df1e46bb-46b9-43ce-9d7d-a19e3589b0ca",5,18,-13,0.0526315789473684,14,10,24,"Positive","Her laver de flest børn på Fyn (df1e46bb-46b9-43ce-9d7d-a19e3589b0ca)",2022-02-23 10:38:20,2022-02-23 10:38:20
"df57ed24-ce86-44c8-9380-437f73dcc84c",1,48,-47,0.00598802395209581,32,31,63,"Positive","Flere oversvømmelser på vej: - Det er en udfordring i 100 millioner kroners klassen (df57ed24-ce86-44c8-9380-437f73dcc84c)",2022-01-10 12:15:18,2022-01-10 12:15:18
"dfa1efaf-9745-425d-b96e-b6da421eb7b1",56,79,-23,0.265402843601896,50,17,67,"Positive","Læge vil have flere fynske akuthjælpere: - Nogle steder er de fem minutter hurtigere end ambulancen (dfa1efaf-9745-425d-b96e-b6da421eb7b1)",2022-03-15 19:14:19,2022-03-15 19:14:19
"e0485d7a-011c-41d5-b669-50c48544cd6a",-11,6,-17,-0.159420289855072,5,14,19,"Negative","Fredagens coronatal: Smitten stiger mindre op til weekenden (e0485d7a-011c-41d5-b669-50c48544cd6a)",2022-02-11 14:24:41,2022-02-11 14:24:41
"e0495e62-54c3-41cc-bc05-e15a3a8da57d",26,38,-12,0.174496644295302,27,9,36,"Positive","Elever strejker for sex på skemaet: - De fleste har deres debut som 16-årig, så det er utrolig vigtigt (e0495e62-54c3-41cc-bc05-e15a3a8da57d)",2022-02-10 20:41:35,2022-02-10 20:41:35
"e09c64ad-776a-40dd-8751-513f74fc1318",-2,15,-17,-0.025,11,11,22,"Negative","Smittetallene falder - men Ærø har landets højeste incidens (e09c64ad-776a-40dd-8751-513f74fc1318)",2022-03-10 17:53:58,2022-03-10 17:53:58
"e17c7ba5-520b-48da-94d5-1beda46f89e0",-8,7,-15,-0.133333333333333,7,8,15,"Negative","Oversvømmelser: Fem gange, hvor vejret satte veje og haver under vand (e17c7ba5-520b-48da-94d5-1beda46f89e0)",2022-01-10 19:43:46,2022-01-10 19:43:46
"e1801d34-45c3-4bb6-b888-2ae6502a9215",3,20,-17,0.0652173913043478,11,9,20,"Positive","Fynboer får svar: Hvad vil du gerne vide om krigen i Ukraine (e1801d34-45c3-4bb6-b888-2ae6502a9215)",2022-03-01 19:24:11,2022-03-01 19:24:11
"e2a25e18-2907-4287-b41d-924f98b82739",39,45,-6,0.414893617021277,26,5,31,"Positive","Danmark Rundt kommer til Fyn: Cykeldirektør glæder sig over fynske etaper (e2a25e18-2907-4287-b41d-924f98b82739)",2022-02-25 18:09:49,2022-02-25 18:09:49
"e2db0660-6f1d-4dec-9f05-df5647a448ec",29,53,-24,0.173652694610778,33,16,49,"Positive","Fynboer 3D-printer hjælp til Ukraine: - Har man et årepres, kan man redde liv (e2db0660-6f1d-4dec-9f05-df5647a448ec)",2022-03-13 14:55:25,2022-03-13 14:55:25
"e2f709e3-4f27-4f3f-9249-df8673926ffd",23,64,-41,0.137724550898204,35,21,56,"Positive","Omskoling af ledige: Kan være en mulig løsning for mangel på arbejdskraft (e2f709e3-4f27-4f3f-9249-df8673926ffd)",2022-01-20 07:22:43,2022-01-20 07:22:43
"e37706f4-7f11-44a2-99de-aedf4e613758",-7,6,-13,-0.0985915492957746,6,8,14,"Negative","Efter skud i Vollsmose bliver en enkelt person stillet for dommer (e37706f4-7f11-44a2-99de-aedf4e613758)",2022-01-13 10:29:30,2022-01-13 10:29:30
"e3d6d002-8a47-4d37-9e35-348d2b0db1a7",26,49,-23,0.184397163120567,35,14,49,"Positive","Asylcentret er genåbnet: Over 150 ukrainere er ankommet til Holmegaard (e3d6d002-8a47-4d37-9e35-348d2b0db1a7)",2022-03-15 12:32:06,2022-03-15 12:32:06
"e449ea82-c9ce-4325-b120-62c856d9f0e2",-9,1,-10,-0.15,1,7,8,"Negative","OB-træner straffes for at hoppe og provokere (e449ea82-c9ce-4325-b120-62c856d9f0e2)",2022-03-09 13:44:51,2022-03-09 13:44:51
"e4951671-094e-4893-b02c-3ded8e02e53d",-8,26,-34,-0.0650406504065041,21,22,43,"Negative","Marco er død: - Han sov stille ind i sin mors arme (e4951671-094e-4893-b02c-3ded8e02e53d)",2022-02-13 12:06:48,2022-02-13 12:06:48
"e4f1021a-c13f-4407-8670-f40a42ff5861",25,65,-40,0.106382978723404,44,26,70,"Positive","Stadig store problemer: Her kommer hver syv ud af otte ambulancer først efter et kvarter (e4f1021a-c13f-4407-8670-f40a42ff5861)",2022-03-09 15:52:59,2022-03-09 15:52:59
"e596e282-18e6-454d-8285-70b96056ef1b",14,29,-15,0.126126126126126,18,11,29,"Positive","Russisk fragtskib i fynsk farvand: Det skærer i øjnene (e596e282-18e6-454d-8285-70b96056ef1b)",2022-03-08 16:28:05,2022-03-08 16:28:05
"e5a2ce17-49f8-447d-9b3e-2dcc3add5928",-17,12,-29,-0.188888888888889,9,20,29,"Negative","Chauffør skal betale regning for at lukke Storebæltsbroen (e5a2ce17-49f8-447d-9b3e-2dcc3add5928)",2022-02-02 20:45:13,2022-02-02 20:45:13
"e5b06991-9f11-4703-9038-577f5d565578",26,34,-8,0.257425742574257,18,6,24,"Positive","OB laver særlig trøje til ære for Lars Høgh (e5b06991-9f11-4703-9038-577f5d565578)",2022-02-14 15:37:36,2022-02-14 15:37:36
"e607f3f9-c14e-4a7a-9a76-f11232a5aaa4",14,25,-11,0.150537634408602,19,9,28,"Positive","Frygt i Bagenkop: Stigende dieselpriser går ud over fiskeriet (e607f3f9-c14e-4a7a-9a76-f11232a5aaa4)",2022-03-11 20:41:56,2022-03-11 20:41:56
"e61a2483-1594-46ee-994e-a40dcd46c8e2",3,53,-50,0.0111940298507463,40,30,70,"Positive","Politikere kræver svar: - Det virker fuldkommen håbløst, at man ikke må flytte et farligt højspændingskabel (e61a2483-1594-46ee-994e-a40dcd46c8e2)",2022-02-21 12:33:41,2022-02-21 12:33:41
"e621cd55-cb25-48e5-a159-a55a280f9210",-9,47,-56,-0.0532544378698225,38,32,70,"Negative","Nyborg-politikere vil ikke læse whistleblowers nødråb: Under halvdelen har bedt om at se korrespondance (e621cd55-cb25-48e5-a159-a55a280f9210)",2022-02-25 19:40:07,2022-02-25 19:40:07
"e65aed8f-37fc-4911-8feb-d4b4f223f34e",-5,8,-13,-0.05,7,7,14,"Negative","Storebæltsbroen er lukket: Få overblikket over, hvordan stormen påvirker trafikken (e65aed8f-37fc-4911-8feb-d4b4f223f34e)",2022-01-29 20:30:00,2022-01-29 19:39:36
"e664b352-c3bf-45e0-9ab0-379795e63718",21,29,-8,0.21875,17,6,23,"Positive","Christian Eriksen er positivt overrasket over egen form (e664b352-c3bf-45e0-9ab0-379795e63718)",2022-02-22 16:46:44,2022-02-22 16:46:44
"e7781561-a3fc-4670-acc5-00dc82b778f8",-2,8,-10,-0.032258064516129,5,7,12,"Negative","Minut for minut: OB mister sejren i Haderslev (e7781561-a3fc-4670-acc5-00dc82b778f8)",2022-03-06 12:58:15,2022-03-06 12:58:15
"e7b0bcc3-ed4c-4e09-9f97-269fd8cf6ec4",-13,7,-20,-0.213114754098361,4,10,14,"Negative","23-årig mand mister livet i trafikulykke på Fyn (e7b0bcc3-ed4c-4e09-9f97-269fd8cf6ec4)",2022-01-31 05:12:31,2022-01-31 05:12:31
"e7be6127-988a-4001-b726-d06714dab89e",44,91,-47,0.268292682926829,55,34,89,"Positive","Jonglering, kolbøtter og grin: Cirkus Flik Flak modtager 220.000 kroner til nyt cirkusgrej (e7be6127-988a-4001-b726-d06714dab89e)",2022-02-21 16:09:12,2022-02-21 16:09:12
"e80db001-feb5-4ddf-911c-815640e12226",-5,11,-16,-0.0909090909090909,8,11,19,"Negative","Kør forsigtigt: Onsdagen begynder med tæt tåge (e80db001-feb5-4ddf-911c-815640e12226)",2022-03-16 05:57:12,2022-03-16 05:57:12
"e83d721d-2e45-4486-bfd6-f99aff97304e",-26,12,-38,-0.232142857142857,9,19,28,"Negative","Langeland Kommune meldt for omsorgsvigt af tvangsfjernede børn (e83d721d-2e45-4486-bfd6-f99aff97304e)",2022-03-18 16:43:49,2022-03-18 16:43:49
"e8baca93-d8c4-4719-8687-091ad017e85c",12,21,-9,0.16,12,7,19,"Positive","Endnu en tåget morgen - men så får solen fat (e8baca93-d8c4-4719-8687-091ad017e85c)",2022-03-09 06:25:45,2022-03-09 06:25:45
"e93109e7-814c-43a6-b9e3-fe2cc4ec6f2b",1,7,-6,0.0212765957446809,6,4,10,"Positive","Bil i brand på motorvejen (e93109e7-814c-43a6-b9e3-fe2cc4ec6f2b)",2022-02-18 12:46:37,2022-02-18 12:46:37
"e9922c65-5b83-4289-bf99-dd4c75179977",-16,12,-28,-0.150943396226415,12,13,25,"Negative","Fyns Politi genindfører visitationszone efter skuddrab på 19-årig (e9922c65-5b83-4289-bf99-dd4c75179977)",2022-02-28 16:17:10,2022-02-28 16:17:10
"e9c9b83d-cf05-4749-93cd-3249fb1021b6",-29,5,-34,-0.333333333333333,4,23,27,"Negative","Far fængslet for at omskære og brænde datter med varm kniv (e9c9b83d-cf05-4749-93cd-3249fb1021b6)",2022-01-25 20:38:00,2022-01-25 20:29:27
"ea20fc98-a605-4226-a60c-3aa8455075af",48,50,-2,0.35036496350365,36,2,38,"Positive","Flere danske successerier: FilmFyn tilslutter sig samarbejde med Netflix (ea20fc98-a605-4226-a60c-3aa8455075af)",2022-01-12 12:28:08,2022-01-12 12:28:08
"ea381798-2ede-4f09-b334-ae3ad2caff62",13,47,-34,0.0742857142857143,37,23,60,"Positive","320.000 husstande får flere tusinde kroner i engangsbeløb til varmehjælp (ea381798-2ede-4f09-b334-ae3ad2caff62)",2022-02-11 10:57:21,2022-02-11 10:57:21
"eac80ada-2ae0-469a-a7be-2c64e9cd9514",35,48,-13,0.286885245901639,31,8,39,"Positive","Datalog laver app til nattelivet: Jeg håber det kan minimere de forfærdelige historier (eac80ada-2ae0-469a-a7be-2c64e9cd9514)",2022-02-19 18:26:34,2022-02-19 18:26:34
"eb10c5f4-7146-486e-8bfc-82baf2f2a09f",18,52,-34,0.108433734939759,40,25,65,"Positive","Energipriser på himmelflugt: Nu har Kristoffer slukket for varmen (eb10c5f4-7146-486e-8bfc-82baf2f2a09f)",2022-01-13 17:05:09,2022-01-13 17:05:09
"eb27b554-8dbf-422f-b834-d917742d9b1c",-5,30,-35,-0.032258064516129,21,22,43,"Negative","Fund af PFOS i fynsk oksekød: Dræn, vandløb og jordbund skal analyseres (eb27b554-8dbf-422f-b834-d917742d9b1c)",2022-01-20 20:28:07,2022-01-20 20:28:07
"eb561e90-c7c1-4747-b5c3-e8fbb634a2ad",17,105,-88,0.0518292682926829,81,53,134,"Positive","Kunstigt lys over Fyn forurener nattehimlen: - Det er helt crazy (eb561e90-c7c1-4747-b5c3-e8fbb634a2ad)",2022-01-22 11:53:11,2022-01-22 11:53:11
"eb658286-0482-4d4f-9904-4bcb1de56798",2,22,-20,0.0111111111111111,21,16,37,"Positive","Nattelivet får ekstra time - alligevel springes stor genåbningsdag over (eb658286-0482-4d4f-9904-4bcb1de56798)",2022-01-28 20:08:54,2022-01-28 20:08:54
"eb7109b9-2c1e-4e16-8a9c-4181dea5d6bd",11,30,-19,0.0973451327433628,20,11,31,"Positive","Fynboer får svar: Hvad sker der, når ukrainerne kommer til Fyn? (eb7109b9-2c1e-4e16-8a9c-4181dea5d6bd)",2022-03-02 12:26:54,2022-03-02 12:26:54
"eb7dac5b-4861-45d6-add7-1f00236dfe70",2,21,-19,0.0194174757281553,13,13,26,"Positive","Sjældent syn på Fyn: Grønt nordlys set på nattehimlen (eb7dac5b-4861-45d6-add7-1f00236dfe70)",2022-03-14 10:39:53,2022-03-14 10:39:53
"eb92e500-307d-4a34-b865-95ef8c31209b",11,39,-28,0.0852713178294574,21,18,39,"Positive","Møgår blev fynsk løgår: Brødre fra Vestfyn har Danmarks bedste løg (eb92e500-307d-4a34-b865-95ef8c31209b)",2022-02-02 08:17:21,2022-02-02 08:17:21
"eb975e63-d7ef-40c3-b95a-418b7749c9a3",20,53,-33,0.101522842639594,32,22,54,"Positive","Kommune og støjgrupper i fælles brev til minister: Hjælp os med at begrænse motorvejsstøj (eb975e63-d7ef-40c3-b95a-418b7749c9a3)",2022-03-20 07:00:51,2022-03-20 07:00:51
"ec32fe53-fa44-4c45-9c2c-30cbc7a34e07",60,79,-19,0.25,56,12,68,"Positive","Millioner på vej til Fyn: Fyn skal være robotteknologiens hovedstad (ec32fe53-fa44-4c45-9c2c-30cbc7a34e07)",2022-02-04 06:00:08,2022-02-04 06:00:08
"ec33897e-8b8b-4348-a3e7-d9535249831e",36,47,-11,0.327272727272727,29,5,34,"Positive","Sex på skoleskemaet: Politikerne vil gøre undervisningen bedre (ec33897e-8b8b-4348-a3e7-d9535249831e)",2022-02-09 18:23:12,2022-02-09 18:23:12
"ec3b8e05-f01a-4587-a272-09e00d641ce1",-2,1,-3,-0.08,1,1,2,"Negative","Se fynboernes billeder fra stormen Malik (ec3b8e05-f01a-4587-a272-09e00d641ce1)",2022-01-31 07:02:12,2022-01-31 07:02:12
"ec6b2b57-522d-4a38-a614-17e60a023ba8",1,30,-29,0.00769230769230769,22,16,38,"Positive","Kritiseret Bramsen: Man kan ikke gøre alle tilfredse (ec6b2b57-522d-4a38-a614-17e60a023ba8)",2022-02-08 10:40:19,2022-02-08 10:40:19
"ec9bdb9a-44c4-46ea-8023-6c883480bf51",6,30,-24,0.046875,23,16,39,"Positive","OUH-overlæge bekymret over Mette F.'s udmelding (ec9bdb9a-44c4-46ea-8023-6c883480bf51)",2022-01-18 21:21:09,2022-01-18 21:21:09
"eca0868c-89fd-40d8-8aa2-baabe151f077",22,24,-2,0.222222222222222,18,2,20,"Positive","Stemmeaftale om Nyborg Slot foreligger: Anlægslov rykker tættere på (eca0868c-89fd-40d8-8aa2-baabe151f077)",2022-02-24 21:26:33,2022-02-24 21:26:33
"ecc645f8-7f8a-48ad-bfce-bf7cf50a89b5",-2,30,-32,-0.0188679245283019,18,17,35,"Negative","Politiet vil have flere til at ringe 112 ved uheld på motorvej (ecc645f8-7f8a-48ad-bfce-bf7cf50a89b5)",2022-01-17 05:18:38,2022-01-17 05:18:38
"ece53f3b-20b5-4c49-93f2-26bf269a6291",19,25,-6,0.166666666666667,18,5,23,"Positive","Ikke penge nok: Fynske projekter kæmper om erhvervsmillioner (ece53f3b-20b5-4c49-93f2-26bf269a6291)",2022-02-14 07:38:16,2022-02-14 07:38:16
"ed3de0c1-9602-4a70-af44-cd2a4d611b75",33,50,-17,0.289473684210526,30,7,37,"Positive","Skoler sætter fokus på digital trivsel (ed3de0c1-9602-4a70-af44-cd2a4d611b75)",2022-03-04 18:36:40,2022-03-04 18:36:40
"ed4c8ca6-0d49-44c0-9e2a-f2ea3ef3e2cf",6,19,-13,0.0810810810810811,11,9,20,"Positive","Tocifrede temperaturer: Flot fynsk forårsdag i vente (ed4c8ca6-0d49-44c0-9e2a-f2ea3ef3e2cf)",2022-03-19 07:22:32,2022-03-19 07:22:32
"ed5e25b8-aebe-45c8-a8ff-ac1b19a50719",51,74,-23,0.435897435897436,38,15,53,"Positive","- Jeg er virkelig stolt, siger Axelsen (ed5e25b8-aebe-45c8-a8ff-ac1b19a50719)",2022-03-19 06:44:21,2022-03-19 06:44:21
"ed7c5e8c-5d00-4517-a548-f33f2a370c4d",1,3,-2,0.0277777777777778,3,1,4,"Positive","Overblik: Se, hvordan slotsprojektet på ti år er blevet forsinket, fordyret og lagt i ruiner (ed7c5e8c-5d00-4517-a548-f33f2a370c4d)",2022-02-09 19:13:13,2022-02-09 19:13:13
"eda4910c-7fa3-4d60-adf7-faf5a431973a",-8,51,-59,-0.036036036036036,35,46,81,"Negative","Tiden er inde til at fjerne restriktioner, mener to eksperter (eda4910c-7fa3-4d60-adf7-faf5a431973a)",2022-01-25 19:01:26,2022-01-25 19:01:26
"eda5219d-290f-4376-9bb6-0272482da696",-17,5,-22,-0.288135593220339,3,11,14,"Negative","Onsdag kan regn gå over i sne og slud (eda5219d-290f-4376-9bb6-0272482da696)",2022-02-16 06:31:29,2022-02-16 06:31:29
"edac1044-48dc-4ba8-b8c5-6c165c847b77",-10,42,-52,-0.0446428571428571,29,29,58,"Negative","Efter negativ omtale: Grønnely lukker ned på internettet (edac1044-48dc-4ba8-b8c5-6c165c847b77)",2022-01-31 15:52:14,2022-01-31 15:52:14
"edf2af15-6968-4431-b026-aa68f16940e7",-10,28,-38,-0.0689655172413793,21,22,43,"Negative","Har spist det i flere år: Giftstof fundet i oksekød fra køer i Odense (edf2af15-6968-4431-b026-aa68f16940e7)",2022-01-19 10:29:04,2022-01-19 10:29:04
"eed320a6-9680-4e65-96b3-872b15a1d6ba",33,59,-26,0.185393258426966,43,21,64,"Positive","Afgiften på Storebælt bremser væksten på Fyn: - Vi bruger hver mulighed til at fremhæve, hvor skævt det er (eed320a6-9680-4e65-96b3-872b15a1d6ba)",2022-03-19 06:09:02,2022-03-19 06:09:02
"ef6627f9-9dbe-40e2-aa0f-0277c4241f3e",1,33,-32,0.00675675675675676,24,17,41,"Positive","Borgmester sender tanker til ukrainsk venskabsby: - Det gør ondt at se på (ef6627f9-9dbe-40e2-aa0f-0277c4241f3e)",2022-02-25 20:56:13,2022-02-25 20:56:13
"f00a6d9b-16ee-4bb0-a596-5c8764459b4f",7,73,-66,0.03125,45,42,87,"Positive","Det grå guld får hjælp til at få job: - Det er svært at holde modet oppe (f00a6d9b-16ee-4bb0-a596-5c8764459b4f)",2022-02-23 06:51:56,2022-02-23 06:51:56
"f029a630-6c75-4b3a-9610-5e157538dfec",80,104,-24,0.402010050251256,65,20,85,"Positive","Streamingtjenester skal betale til dansk indhold: Magnus tør drømme om at ende på Netflix (f029a630-6c75-4b3a-9610-5e157538dfec)",2022-02-04 17:34:38,2022-02-04 17:34:38
"f065bc88-99f0-4a95-94be-8c639efbddb5",2,9,-7,0.0350877192982456,7,5,12,"Positive","The Minds of 99 spiller på fynsk festival (f065bc88-99f0-4a95-94be-8c639efbddb5)",2022-01-26 10:07:40,2022-01-26 10:07:40
"f09a3efb-d39e-4a0d-a759-a02f0650b139",12,33,-21,0.0991735537190083,26,13,39,"Positive","Tvang skal give flere læger i udkantsområder (f09a3efb-d39e-4a0d-a759-a02f0650b139)",2022-03-15 16:06:58,2022-03-15 16:06:58
"f0ff6011-1972-4b40-8f4e-0cad8d2bda8d",28,39,-11,0.277227722772277,27,6,33,"Positive","Rotary Klub samler ind til Ukraine: - Vi kan dedikere hjælpen derhen, hvor der er brug for den (f0ff6011-1972-4b40-8f4e-0cad8d2bda8d)",2022-03-04 20:04:33,2022-03-04 20:04:33
"f17be923-e364-4e8d-bdab-509177e9b655",21,56,-35,0.116022099447514,40,20,60,"Positive","Thulesen Dahl afviser at sætte navn på sin brors afløser: - Jeg havde gerne set, at han havde kæmpet videre (f17be923-e364-4e8d-bdab-509177e9b655)",2022-01-19 19:58:08,2022-01-19 19:58:08
"f19ef88b-11ef-40f0-bd71-4bc632064017",11,26,-15,0.104761904761905,14,9,23,"Positive","Måske har du også undret dig: Derfor skal børnehaveklasserne ikke testes (f19ef88b-11ef-40f0-bd71-4bc632064017)",2022-01-17 11:08:07,2022-01-17 11:08:07
"f1b3169d-7ce7-4763-9b94-ffcf4472bafc",-14,33,-47,-0.11864406779661,22,32,54,"Negative","Lærerforeninger i opråb: Vi spiller hasard med de ansattes helbred (f1b3169d-7ce7-4763-9b94-ffcf4472bafc)",2022-01-24 12:04:25,2022-01-24 12:04:25
"f1c832e7-5436-4c2d-b4fd-675f4a158215",53,55,-2,0.576086956521739,32,2,34,"Positive","Karen Brødsgaard stopper som assistent i Odense (f1c832e7-5436-4c2d-b4fd-675f4a158215)",2022-02-21 17:22:50,2022-02-21 17:22:50
"f23d5da1-6702-46cc-9808-92b524ff85bc",8,15,-7,0.140350877192982,12,5,17,"Positive","Vejret påvirker trafikken flere steder på Fyn (f23d5da1-6702-46cc-9808-92b524ff85bc)",2022-02-13 06:31:33,2022-02-13 06:31:33
"f26417c6-6f5f-4745-9608-8e4a297dd733",-11,19,-30,-0.142857142857143,13,17,30,"Negative","Akutmodtagelsen på OUH er fortsat hårdt presset af Covid-19 (f26417c6-6f5f-4745-9608-8e4a297dd733)",2022-03-01 20:56:44,2022-03-01 20:56:44
"f2a8a104-ab3a-4248-8793-08b03a08a63d",20,29,-9,0.212765957446809,19,7,26,"Positive","Alle undtagen én er over 70: Yngre kræfter kan afgøre Egeskov Mølles fremtid (f2a8a104-ab3a-4248-8793-08b03a08a63d)",2022-01-29 17:09:58,2022-01-29 17:09:58
"f3009a48-2dc2-4c9f-a48e-6885156184b6",-27,24,-51,-0.228813559322034,21,28,49,"Negative","Kendt fynsk erhvervsmand skal i retten (f3009a48-2dc2-4c9f-a48e-6885156184b6)",2022-02-08 17:01:05,2022-02-08 17:01:05
"f309755a-2875-4f5a-b9b7-4100d0420cc7",11,22,-11,0.120879120879121,16,6,22,"Positive","Torunn efterlyser flere kvinder på Odense Havn: - Det virker ikke på mig, som om de gør noget specielt for det (f309755a-2875-4f5a-b9b7-4100d0420cc7)",2022-01-21 18:52:20,2022-01-21 18:52:20
"f3191ae4-8c61-4e5d-bcb2-38386f6b23e5",-27,20,-47,-0.287234042553192,10,25,35,"Negative","Russer i Danmark: - Det her må bare ikke ske (f3191ae4-8c61-4e5d-bcb2-38386f6b23e5)",2022-02-24 20:48:45,2022-02-24 20:48:45
"f3287079-e6a8-4e00-93e5-ff525595d968",42,73,-31,0.242774566473988,43,19,62,"Positive","Legendetrøje blev et uskønt forløb: - OB står tilbage med at rap over nallerne (f3287079-e6a8-4e00-93e5-ff525595d968)",2022-02-22 21:30:06,2022-02-22 21:30:06
"f33d9ef5-8265-4941-ab7f-7b26d29b7610",-6,35,-41,-0.0335195530726257,21,24,45,"Negative","Russisk olietanker forsøgt standset ud for Langeland (f33d9ef5-8265-4941-ab7f-7b26d29b7610)",2022-03-19 13:10:34,2022-03-19 13:10:34
"f4072b2e-0870-495a-a018-5fbda02e62b4",-22,14,-36,-0.215686274509804,11,16,27,"Negative","Stor politiaktion: Ti personer anholdt efter knivoverfald i Odense (f4072b2e-0870-495a-a018-5fbda02e62b4)",2022-03-01 12:02:07,2022-03-01 12:02:07
"f4444cd7-dcdb-4147-b2d4-38a3822837d7",30,38,-8,0.37037037037037,21,7,28,"Positive","Her er de mest populære navne på Fyn (f4444cd7-dcdb-4147-b2d4-38a3822837d7)",2022-01-19 08:32:56,2022-01-19 08:32:56
"f4577d34-71b1-468c-9f45-88b34f4f4825",0,6,-6,0,4,4,8,"Negative","Efter problemer med at få ukrainere ud af Polen: Bus med flygtninge kører mod Fyn torsdag (f4577d34-71b1-468c-9f45-88b34f4f4825)",2022-03-03 07:42:50,2022-03-03 07:42:50
"f4c213f8-bce6-483b-8fd7-540678657885",7,52,-45,0.0328638497652582,33,33,66,"Positive","Nyborg undgik regningen: Færgen Broen er i forfald og vil koste dyrt (f4c213f8-bce6-483b-8fd7-540678657885)",2022-03-10 05:24:20,2022-03-10 05:24:20
"f4ded7e6-7c4f-4694-8500-d9b36a40b061",39,55,-16,0.26530612244898,31,10,41,"Positive","4.500 sygehusansatte kan forvente lønforhøjelse (f4ded7e6-7c4f-4694-8500-d9b36a40b061)",2022-01-25 06:06:17,2022-01-25 06:06:17
"f4e6b0cb-a5cf-4f46-8f84-9f6a6eee532e",-6,23,-29,-0.0422535211267606,18,17,35,"Negative","Syrisk flygtning om ny særlov: - Mørke mennesker bliver B-flygtninge (f4e6b0cb-a5cf-4f46-8f84-9f6a6eee532e)",2022-03-21 05:22:53,2022-03-21 05:22:53
"f55c5a4c-5c8c-4562-af36-29c06766c51b",13,30,-17,0.138297872340426,20,11,31,"Positive","Sag om flybrændstof: Bunkerchef trækker sig fra bestyrelse efter dom (f55c5a4c-5c8c-4562-af36-29c06766c51b)",2022-01-17 09:54:22,2022-01-17 09:54:22
"f5d04733-bf79-4ef9-9bd3-d46367fc26fe",20,71,-51,0.138888888888889,37,28,65,"Positive","Ukrainer om krigen: - Jeg håber, menneskeheden kan lære noget af det her (f5d04733-bf79-4ef9-9bd3-d46367fc26fe)",2022-03-02 19:03:44,2022-03-02 19:03:44
"f611313c-6b72-452b-8fb7-62782e1fccc2",15,25,-10,0.208333333333333,17,6,23,"Positive","Fredssang i Faaborg: - Man skal lave små manifestationer, når man kan og vil (f611313c-6b72-452b-8fb7-62782e1fccc2)",2022-03-13 05:59:23,2022-03-13 05:59:23
"f625418d-aedc-4942-9562-511a4803ef93",23,47,-24,0.132183908045977,29,18,47,"Positive","Fynske efterskoler hårdt ramt af corona: - Det slår os ikke ud (f625418d-aedc-4942-9562-511a4803ef93)",2022-01-18 16:42:47,2022-01-18 16:42:47
"f6ba5402-14a5-4bf3-9aba-39333f401348",6,11,-5,0.130434782608696,6,4,10,"Positive","Vinterferien starter lunt men skyet (f6ba5402-14a5-4bf3-9aba-39333f401348)",2022-02-14 06:39:04,2022-02-14 06:39:04
"f7492e63-407c-4ce1-8ef4-5f79b676027d",4,22,-18,0.0470588235294118,16,14,30,"Positive","Én grad lavere sparer fem procent på varmeregningen - sådan sparer du selv (f7492e63-407c-4ce1-8ef4-5f79b676027d)",2022-03-08 19:08:46,2022-03-08 19:08:46
"f7653534-131a-45b8-ad3d-588f5eb66bed",-8,5,-13,-0.163265306122449,4,8,12,"Negative","Kan du genkende cyklen? Røver med pistol truede sig til penge (f7653534-131a-45b8-ad3d-588f5eb66bed)",2022-02-07 19:56:00,2022-02-07 18:56:37
"f81bb02e-594f-46b4-b866-2c99db219a2c",17,36,-19,0.129770992366412,28,14,42,"Positive","Thomas Frank: Eriksen skal nok vente nogle uger på kamp (f81bb02e-594f-46b4-b866-2c99db219a2c)",2022-02-03 15:43:41,2022-02-03 15:43:41
"f86e2178-5043-48f9-a36e-4660075cd97c",10,50,-40,0.0555555555555556,32,23,55,"Positive","Fynske Heindahls billet til Rusland er ugyldig: - En speciel situation (f86e2178-5043-48f9-a36e-4660075cd97c)",2022-02-28 19:32:58,2022-02-28 19:32:58
"f88bf2ee-a454-4d41-8647-8b03c2c05c75",20,41,-21,0.2,25,13,38,"Positive","Landstrænerens ord er en stor forløsning for Kirkeløkke (f88bf2ee-a454-4d41-8647-8b03c2c05c75)",2022-01-28 16:35:58,2022-01-28 16:35:58
"f8f55510-711f-471b-8a96-2340a1a2726e",9,22,-13,0.0782608695652174,16,10,26,"Positive","Efter næsten et års ventetid: Nu kan Baltic Pipe fortsætte arbejdet på Vestfyn (f8f55510-711f-471b-8a96-2340a1a2726e)",2022-03-01 10:51:18,2022-03-01 10:51:18
"f98a044e-9762-4321-987c-9ac8d8a10546",19,35,-16,0.12258064516129,26,11,37,"Positive","Underskriften er sat: Fyns billigste villa solgt (f98a044e-9762-4321-987c-9ac8d8a10546)",2022-01-29 14:45:40,2022-01-29 14:45:40
"f9eb136d-95a0-4260-8a07-ed8d71da08ac",1,14,-13,0.0208333333333333,11,8,19,"Positive","Otte gode råd: Sådan sikrer du dit hjem mod storm (f9eb136d-95a0-4260-8a07-ed8d71da08ac)",2022-01-28 14:53:57,2022-01-28 14:53:57
"fa234eb2-bf2e-4bc1-b0d0-405f074733c3",13,43,-30,0.099236641221374,23,18,41,"Positive","Slut med test på skoler og daginstitutioner (fa234eb2-bf2e-4bc1-b0d0-405f074733c3)",2022-02-21 20:05:59,2022-02-21 20:05:59
"fa575f40-423d-44fa-a56e-94cd00d04f24",-3,10,-13,-0.0422535211267606,10,8,18,"Negative","Hus brændt i Svendborg - en beboer er sendt på sygehuset (fa575f40-423d-44fa-a56e-94cd00d04f24)",2022-02-22 08:04:40,2022-02-22 08:04:40
"fa7ac81e-6c6a-4dd7-a2aa-e9d87073ad86",-43,22,-65,-0.286666666666667,17,36,53,"Negative","Mand dømt for seksuelle overgreb på sin datter og barnebarn (fa7ac81e-6c6a-4dd7-a2aa-e9d87073ad86)",2022-01-26 15:43:07,2022-01-26 15:43:07
"fadba6bc-9baf-4a9f-b530-f11c0323667f",-1,15,-16,-0.010989010989011,9,10,19,"Negative","Flygtninge på vej til Danmark: 450.000 ukrainere er allerede flygtet til Polen (fadba6bc-9baf-4a9f-b530-f11c0323667f)",2022-03-02 11:12:50,2022-03-02 11:12:50
"fb1c1a20-11c3-4cc1-9abd-ab449c785d28",39,57,-18,0.261744966442953,39,14,53,"Positive","Krig i Ukraine kan give højere energipriser: Energiselskab kimet ned af gaskunder (fb1c1a20-11c3-4cc1-9abd-ab449c785d28)",2022-02-25 15:53:14,2022-02-25 15:53:14
"fc92a223-bbbc-4708-bff2-bc74e7e37de7",4,90,-86,0.0128617363344051,59,46,105,"Positive","Presset stiger på Bramsen: Men bliver hun fyret? (fc92a223-bbbc-4708-bff2-bc74e7e37de7)",2022-01-14 19:50:32,2022-01-14 19:50:32
"fcaf6d6b-8150-45f2-9d96-5ad7d96be993",2,12,-10,0.0238095238095238,10,6,16,"Positive","60-årig mand gemte heroin i sin støvsuger (fcaf6d6b-8150-45f2-9d96-5ad7d96be993)",2022-03-10 14:26:39,2022-03-10 14:26:39
"fd1b9ded-0683-4a67-bd15-b7d323a6a5e8",-28,27,-55,-0.220472440944882,21,35,56,"Negative","Trods høj smitte: Indlæggelsestallene er faldende på OUH (fd1b9ded-0683-4a67-bd15-b7d323a6a5e8)",2022-01-17 15:03:47,2022-01-17 15:03:47
"fd1bd1bc-853e-4ab0-9e3a-33b099d0c74c",-3,14,-17,-0.0263157894736842,14,11,25,"Negative","Nu begynder de danske åer at give problemer (fd1bd1bc-853e-4ab0-9e3a-33b099d0c74c)",2022-02-23 07:40:31,2022-02-23 07:40:31
"fd321dba-f8c7-4661-9c74-e97d5248a854",3,8,-5,0.06,6,5,11,"Positive","Tåget og lun onsdag kan begynde med glatte veje (fd321dba-f8c7-4661-9c74-e97d5248a854)",2022-01-12 06:21:02,2022-01-12 06:21:02
"fd7c5a98-8fb4-45b5-a263-643c6e3a1e08",12,40,-28,0.0888888888888889,24,23,47,"Positive","Eriksen er med til at bremse skidt stime for Brentford (fd7c5a98-8fb4-45b5-a263-643c6e3a1e08)",2022-03-05 17:15:19,2022-03-05 17:15:19
"fe2b9bec-d8f7-489e-bf6c-294ceabc7290",-45,43,-88,-0.238095238095238,33,44,77,"Negative","Chikane, trusler og tilråb mod kommunale politikere: - Det kan have konsekvenser for demokratiet (fe2b9bec-d8f7-489e-bf6c-294ceabc7290)",2022-02-24 07:07:17,2022-02-24 07:07:17
"fe469ca2-3c99-48a5-b6f7-5c31c4865ae2",-15,1,-16,-0.428571428571429,1,8,9,"Negative","Røveri med pistol mod Coop365: Politi efterlyser røver (fe469ca2-3c99-48a5-b6f7-5c31c4865ae2)",2022-02-07 06:38:03,2022-02-07 06:38:03
"fe72e8de-f7cf-4145-ad91-fb9fd7501227",29,40,-11,0.292929292929293,19,7,26,"Positive","OB misser vigtige point til Vejle (fe72e8de-f7cf-4145-ad91-fb9fd7501227)",2022-03-20 15:44:01,2022-03-20 15:44:01
"fe86396f-d361-42d5-8fa3-1b561acf85d7",-4,11,-15,-0.043956043956044,8,13,21,"Negative","Stigende smitte og sygemeldinger på vej mod Fyn (fe86396f-d361-42d5-8fa3-1b561acf85d7)",2022-02-06 09:02:12,2022-02-06 09:02:12
"fe9fdcca-6876-4eb6-a670-debc5e5234eb",26,39,-13,0.247619047619048,23,9,32,"Positive","Fynsk sparekasse leverer sit største overskud nogensinde (fe9fdcca-6876-4eb6-a670-debc5e5234eb)",2022-02-11 05:12:59,2022-02-11 05:12:59
"fef373f6-4d50-4076-a553-114c7846b122",5,37,-32,0.0326797385620915,20,22,42,"Positive","Bomberne faldt ved Mugels hjem i Kyiv - nu er han på vej til Fyn (fef373f6-4d50-4076-a553-114c7846b122)",2022-03-03 17:12:31,2022-03-03 17:12:31
"ff218319-02e0-4d9c-905a-24ee48fbd687",14,38,-24,0.0945945945945946,25,17,42,"Positive","Bramsen efter ministerskifte: Politik er ikke en fair branche (ff218319-02e0-4d9c-905a-24ee48fbd687)",2022-02-08 08:07:18,2022-02-08 08:07:18
"ff56c30e-6f8e-4f8f-bd0f-2ccf363ca991",21,34,-13,0.162790697674419,23,10,33,"Positive","Inflationen har taget største hop siden 1989 (ff56c30e-6f8e-4f8f-bd0f-2ccf363ca991)",2022-03-10 08:01:52,2022-03-10 08:01:52
"fff81889-13e6-4cf4-b8f3-d65021e0bdad",-3,7,-10,-0.0535714285714286,5,8,13,"Negative","Kun én kommune har faldende incidens: Fyn sætter kedelig rekord i smittetilfælde (fff81889-13e6-4cf4-b8f3-d65021e0bdad)",2022-01-15 13:46:55,2022-01-15 13:46:55
"fff9ccba-6a1b-4bed-bdf3-8b21071aae2a",26,50,-24,0.204724409448819,31,15,46,"Positive","Ukrainske Marharyta blev fanget i Danmark og arbejder nu som dansk journalist (fff9ccba-6a1b-4bed-bdf3-8b21071aae2a)",2022-03-17 21:54:18,2022-03-17 21:54:18
"aa4ba4a5-3780-46ba-895a-ca77f1dfbae4",24,42,-18,0.206896551724138,27,11,38,"Positive","Det ukrainske flag vajer over Flakhaven: - Det er en kæmpe stor ting for os (aa4ba4a5-3780-46ba-895a-ca77f1dfbae4)",2022-03-02 16:42:38,2022-03-02 16:42:38
"aa71bf45-330e-462c-b454-87662dfc5740",-2,8,-10,-0.0307692307692308,7,9,16,"Negative","Se smitten i dit sogn: Over 16.000 smittede på Fyn den seneste uge (aa71bf45-330e-462c-b454-87662dfc5740)",2022-01-20 13:59:55,2022-01-20 13:59:55
"aa989eaa-18ef-4160-bcf8-9114d69e905b",15,33,-18,0.126050420168067,21,13,34,"Positive","Tidligere orkan kommer med sne til Fyn (aa989eaa-18ef-4160-bcf8-9114d69e905b)",2022-02-09 15:40:27,2022-02-09 15:40:27
"aad74e31-b702-44b6-8a79-145d27c99d8a",50,80,-30,0.297619047619048,55,19,74,"Positive","Efter stor efterspørgsel: Rådgivningscenter for unge åbner i Faaborg (aad74e31-b702-44b6-8a79-145d27c99d8a)",2022-02-28 14:05:15,2022-02-28 14:05:15
